30 100
GTCCATCTTGTGTACGGCTGCTAGGCGGAG|AGCGATAAATTCCTCAGCTCTATCAGTTGC
TTCTCTTAGGTCTCGGTTGTGTATTTATAT|AATAGTCTCCCAACCCCACTCTAGCCCTGA
CAACCCCACTCTAGCCCTCTCGCGCCGTTT|CTTATAATAGTCTCCCAACCCCACTCTAGC
TACGGCGAGCTTCTTATAATAGTCTCCCAA|GCCCAAGCCCGTCCTACGGACTGTTAGAAG
AACTTTCTTGGTCCGGATCATAGGTGCCGG|ATATATAATAGTCTCCCAACCCCACTCTAT
CCAACCCCACTCTAGCCCTTGAATTCCATG|AACCCCACTCTAGCCCGCGGGTCTCATAGG
AGGGTGCTCTTTGCCTACGAATGGACTGGG|CTCTAGCCCTCTCGCGCCGTTTCAGGTGTG
ATAATAGTCTCCCAACCCCACTCTAGCCCG|GACTGGGATGGAAAGCGGGTGTTTCAGGTT
CTTTCGGGACACGGGAGATAACATTATACA|CTCTAGCCCATGTTGACATGATATAATAGT
GAGCGATAAATTCCTCAGCTCTATCAGTTG|CTTTCGGGACACGGGAGATAACATTATACA
GCTCACACGAAGATATAATAGTCTCCCAAC|ATTCTACAGTAAACTCTCGGCCCTGCTACT
TAGCCGGAAGAGGCCTAGTGGGAACTCCTT|TCAGATTTTTACATAGACCATGCCTTCTGC
GTTTGACTCCTTTCGGGACACGGGAGATAA|CCAACCCCACTCTAGCCCATGTTGACATGA
CTCCCAACCCCACTCTAGCCCTAGCCCATA|CTCCCAACCCCACTCTAGCCCCGCTACGGC
TAGGCGGAGGATGTCGCTTTTATTTCTCTT|ATCAGTTGCTCACACGAAGATATAATAGTC
CACTGCTTAAGCTCTAATACGTAGCAGTGG|GCGGAGGATGTCGCTTTTATTTCTCTTAGG
ATAATAGTCTCCCAACCCCACTCTAGCCCT|TCTCGGCCCTGCTACTAGATTTAATTATTA
TCTCCCAACCCCACTCTAGCCCCCAACCCC|TATTGCGCAGAATTTGACCAGTGGTCATCA
TCTAATACGTAGCAGTGGTCAGTGCTAATG|GCTTTTATTTCTCTTAGGTCTCGGTTGTGT
GTCTCCCAACCCCACTCTAGCCCTCTCGCG|GAGCTTCTTATAATAGTCTCCCAACCCCAC
GCTAATGTTAGTGGTATAATAGTCTCCCAA|GTTGTGTATTTATATAATAGTCTCCCAACC
CCAACCCCACTCTATAATAGTCTCCCAACC|ACAGAATACCAATATAATAGTCTCCCAACC
CAGTTGCTCACACGAAGATATAATAGTCTC|TATACATTCTACAGTAAACTCTCGGCCCTG
GCTCTAATACGTAGCAGTGGTCAGTGCTAA|TCGCTTTTATTTCTCTTAGGTCTCGGTTGT
TAGCCCCGCCATCTGGTTAGCCGGAAGAGG|ACTAATGATACCTTCCTTCAGATTTTTACA
CTACGGACTGTTAGAAGATATTCGCCGTTT|GCTGACTTGGGCCTTCCCCGACCACTGCTT
TCAGCTCTATCAGTTGCTCACACGAAGATA|GAGATAACATTATACATTCTACAGTAAACT
GTCTCCCAACCCCACTCTAGCCCGAACCAG|CAATAGGGTGCTCTTTGCCTACGAATGGAC
GAATGGACTGGGACGGCGCTGCGAAATTTG|GTTTCAGGTGTGAGGTGGCAAATTAGAGTC
CTAGATTTAATTATTAAGGAGGTATAATAG|CTGGTTAGCCGGAAGAGGCCTAGTGGGAAC
TTATATAATAGTCTCCCAACCCCACTCTAG|CCCTGACTGGGATGGAAAGCGGGTGTTTCA
GACATGATATAATAGTCTCCCAACCCCACT|GTAGATTAACATTGGCAATCAGATGGGATG
ATTCCTCAGCTCTATCAGTTGCTCACACGA|CACGGGAGATAACATTATACATTCTACAGT
TTTTCAACTTTCTTGGTCCGGATCATAGGT|TTGTTATATATAATAGTCTCCCAACCCCAC
ATTTCTCTTAGGTCTCGGTTGTGTATTTAT|ATAATAGTCTCCCAACCCCACTCTAGCCCT
CATGTTGACATGATATAATAGTCTCCCAAC|TTCCCGGTAGATTAACATTGGCAATCAGAT
GCGCCGTTTCAGGTGTGAGGTGGCAAATTA|CACTCTAGCCCACTTGAGAGGCCACCAAAT
CTCTATAATAGTCTCCCAACCCCACTCTAG|CAATATAATAGTCTCCCAACCCCACTCTAG
CGTTAGCTATTGCGCAGAATTTGACCAGTG|CTGAATGGCTCGGACCGCAGGCGGCCACCG
TTTCTTGGTCCGGATCATAGGTGCCGGTAT|TATAATAGTCTCCCAACCCCACTCTATAAT
CACTCTAGCCCAAGCCCGTCCTACGGACTG|CATAGTGTGTGGACTGGCAGGCTGACTTGG
ATCTATAACAGCCCAATAGGGTGCTCTTTG|ATAGTCTCCCAACCCCACTCTAGCCCTCTC
CCGTCATCTATAACAGCCCAATAGGGTGCT|AGCCCATAGTCTCCCAACCCCACTCTAGCC
GTAGCAGTGGTCAGTGCTAATGTTAGTGGT|TTCTCTTAGGTCTCGGTTGTGTATTTATAT
TCTAGCCCTCTCGCGCCGTTTCAGGTGTGA|GTCTCCCAACCCCACTCTAGCCCACTTGAG
GCTACAGAATACCAATATAATAGTCTCCCA|ACTCTAGCCCACTTGTCTCCTATATAATAG
CTAGCCCCGCTACGGCGAGCTTCTTATAAT|CCCCACTCTAGCCCAAGCCCGTCCTACGGA
GTAAGGCTTGCGACAAGGGAATGTAGCATA|CAACCCCACTCTAGCCCTTGAATTCCATGT
ATTTGACCAGTGGTCATCAGCGTCCAACTT|AGGCGGCCACCGGGAACTATAATGATGGGC
TGTCTCCTATATAATAGTCTCCCAACCCCA|CAGTAAGGCTTGCGACAAGGGAATGTAGCA
TAATAGTCTCCCAACCCCACTCTAGCCCAC|CTCCTTAAGGTTCGGTGATATGCATGCGTG
GGTATAATAGTCTCCCAACCCCACTCTAGC|ATAATAGTCTCCCAACCCCACTCTAGCCCT
TAGCCCACTTGAGAGGCCACCAAATATAAT|CGTTTACAGGGTCAGAGGGATAAAGGCTCC
CACGGCTACAGAATACCAATATAATAGTCT|CCCCACTCTAGCCCACTTGTCTCCTATATA
TAATAGTCTCCCAACCCCACTCTAGCCCTT|ATAGTCTCCCAACCCCACTCTAGCCCGCGG
TAGTCTCCCAACCCCACTCTAGCCCCCAAC|AGCTATTGCGCAGAATTTGACCAGTGGTCA
TTCCAGGAGCGATAAATTCCTCAGCTCTAT|TGACTCCTTTCGGGACACGGGAGATAACAT
CCCACTCTAGCCCACTTGTCTCCTATATAA|TGATATGCATGCGTGGCAGTAAGGCTTGCG
CCCACTCTAGCCCTCTCGCGCCGTTTCAGG|TAATAGTCTCCCAACCCCACTCTAGCCCAC
GCGACAAGGGAATGTAGCATAGTGTGTGGA|TCTAGCCCTTGAATTCCATGTTAAGGCCCA
ACGACCTTCCAGGAGCGATAAATTCCTCAG|GTCGTTTGACTCCTTTCGGGACACGGGAGA
TCTAGCCCCGCCATCTGGTTAGCCGGAAGA|GCACTAATGATACCTTCCTTCAGATTTTTA
ATAAAGGCTCCTTAAGGTTCGGTGATATGC|AGCAGTGGTCAGTGCTAATGTTAGTGGTAT
CAGTATGGATTCATCGACGATCTTTTCAAC|GACTGGGACGGCGCTGCGAAATTTGTTATA
CCCACTCTAGCCCTAGCCCATAGTCTCCCA|CCCACTCTAGCCCCGCTACGGCGAGCTTCT
GCCGAAGAGCCACGGCTACAGAATACCAAT|AGTCTCCCAACCCCACTCTAGCCCACTTGT
AGTCTCCCAACCCCACTCTAGCCCGTCATC|CTCCCAACCCCACTCTAGCCCTAGCCCATA
GTCCGGATCATAGGTGCCGGTATAATAGTC|GTCTCCCAACCCCACTCTATAATAGTCTCC
TAGTCTCTATAATAGTCTCCCAACCCCACT|AACTCCTTCGTTAGCTATTGCGCAGAATTT
GGAAAGCGGGTGTTTCAGGTTATTGCCAGA|AATAGTCTCTATAATAGTCTCCCAACCCCA
AAATTAGAGTCGCCGAAGAGCCACGGCTAC|CCAAATATAATAGTCTCCCAACCCCACTCT
AACCCCACTCTAGCCCTGACTGGGATGGAA|ACTAGATTTAATTATTAAGGAGGTATAATA
ACGGGAGATAACATTATACATTCTACAGTA|TGTTGACATGATATAATAGTCTCCCAACCC
CCGACCACTGCTTAAGCTCTAATACGTAGC|GCTAGGCGGAGGATGTCGCTTTTATTTCTC
GGAGCGATAAATTCCTCAGCTCTATCAGTT|CCTTTCGGGACACGGGAGATAACATTATAC
TTAGAGTCGCCGAAGAGCCACGGCTACAGA|AATATAATAGTCTCCCAACCCCACTCTAGC
AACGACCTTCCAGGAGCGATAAATTCCTCA|AGTCGTTTGACTCCTTTCGGGACACGGGAG
GGGCCTTCCCCGACCACTGCTTAAGCTCTA|TGTACGGCTGCTAGGCGGAGGATGTCGCTT
GCTAGGCGGAGGATGTCGCTTTTATTTCTC|CTATCAGTTGCTCACACGAAGATATAATAG
TAGCCCGCGGGTCTCATAGGCAACGACCTT|TCAGGTTATTGCCAGATCGCGAGTCGTTTG
CCATGTTGACATGATATAATAGTCTCCCAA|CTTCCCGGTAGATTAACATTGGCAATCAGA
CCTTCCCCGACCACTGCTTAAGCTCTAATA|ACGGCTGCTAGGCGGAGGATGTCGCTTTTA
TAAGGTTCGGTGATATGCATGCGTGGCAGT|TGCTAATGTTAGTGGTATAATAGTCTCCCA
CCGCCATCTGGTTAGCCGGAAGAGGCCTAG|TGATACCTTCCTTCAGATTTTTACATAGAC
GATCATAGGTGCCGGTATAATAGTCTCCCA|CCAACCCCACTCTATAATAGTCTCCCAACC
CAACCCCACTCTAGCCCGAACCAGTATGGA|GGTGCTCTTTGCCTACGAATGGACTGGGAC
GTGGCAGTAAGGCTTGCGACAAGGGAATGT|GTCTCCCAACCCCACTCTAGCCCTTGAATT
GACTGTTAGAAGATATTCGCCGTTTACAGG|CTTGGGCCTTCCCCGACCACTGCTTAAGCT
GTATAATAGTCTCCCAACCCCACTCTAGCC|TAATAGTCTCCCAACCCCACTCTAGCCCTA
ATAGTCTCCCAACCCCACTCTAGCCCTAGC|ATAGTCTCCCAACCCCACTCTAGCCCCGCT
GCCCACTTGAGAGGCCACCAAATATAATAG|TTTACAGGGTCAGAGGGATAAAGGCTCCTT
TTCAGGTTATTGCCAGATCGCGAGTCGTTT|ATAGTCTCCCAACCCCACTCTAGCCCCCAA
AGGCAACGACCTTCCAGGAGCGATAAATTC|CGCGAGTCGTTTGACTCCTTTCGGGACACG
TCTCTATAATAGTCTCCCAACCCCACTCTA|TCCTTCGTTAGCTATTGCGCAGAATTTGAC
CAACTTTCTTGGTCCGGATCATAGGTGCCG|TATATATAATAGTCTCCCAACCCCACTCTA
CCACTCTAGCCCGAACCAGTATGGATTCAT|TCTTTGCCTACGAATGGACTGGGACGGCGC
CCCACAGCAGTCCATCTTGTGTACGGCTGC|CCTTCCAGGAGCGATAAATTCCTCAGCTCT
TAATAGTCTCCCAACCCCACTCTAGCCCGC|ACTGGGATGGAAAGCGGGTGTTTCAGGTTA
TACATTCTACAGTAAACTCTCGGCCCTGCT|TAGTCTCCCAACCCCACTCTAGCCCCGCCA
CACTCTATAATAGTCTCCCAACCCCACTCT|ACCAATATAATAGTCTCCCAACCCCACTCT
TCTCCCAACCCCACTCTAGCCCTTGAATTC|TCCCAACCCCACTCTAGCCCGCGGGTCTCA
CCCACTTGTCTCCTATATAATAGTCTCCCA|GCGTGGCAGTAAGGCTTGCGACAAGGGAAT
CCTAGTGGGAACTCCTTCGTTAGCTATTGC|TAGACCATGCCTTCTGCCTGAATGGCTCGG
CTGTTAGAAGATATTCGCCGTTTACAGGGT|TGGGCCTTCCCCGACCACTGCTTAAGCTCT
ATCTTTTCAACTTTCTTGGTCCGGATCATA|AATTTGTTATATATAATAGTCTCCCAACCC
CCCACTCTAGCCCGAACCAGTATGGATTCA|CTCTTTGCCTACGAATGGACTGGGACGGCG
CTACTAGATTTAATTATTAAGGAGGTATAA|CATCTGGTTAGCCGGAAGAGGCCTAGTGGG
ACGGACTGTTAGAAGATATTCGCCGTTTAC|TGACTTGGGCCTTCCCCGACCACTGCTTAA
TCTCCCAACCCCACTCTAGCCCGTCATCTA|CCCAACCCCACTCTAGCCCTAGCCCATAGT
TAGTCTCCCAACCCCACTCTAGCCCGCGGG|GGGATGGAAAGCGGGTGTTTCAGGTTATTG
CCCCGACCACTGCTTAAGCTCTAATACGTA|CTGCTAGGCGGAGGATGTCGCTTTTATTTC
TAGAAGATATTCGCCGTTTACAGGGTCAGA|CCTTCCCCGACCACTGCTTAAGCTCTAATA
AGCCCTTGAATTCCATGTTAAGGCCCACAG|CCCGCGGGTCTCATAGGCAACGACCTTCCA
TAGTCTCCCAACCCCACTCTAGCCCGAACC|CCCAATAGGGTGCTCTTTGCCTACGAATGG
AGATAACATTATACATTCTACAGTAAACTC|ACATGATATAATAGTCTCCCAACCCCACTC
CTTCCAGGAGCGATAAATTCCTCAGCTCTA|TTGACTCCTTTCGGGACACGGGAGATAACA
AGGGTCAGAGGGATAAAGGCTCCTTAAGGT|GCTCTAATACGTAGCAGTGGTCAGTGCTAA
TGGCAGTAAGGCTTGCGACAAGGGAATGTA|TCTCCCAACCCCACTCTAGCCCTTGAATTC
CAGAATTTGACCAGTGGTCATCAGCGTCCA|CCGCAGGCGGCCACCGGGAACTATAATGAT
CAACCCCACTCTAGCCCGTCATCTATAACA|CCCCACTCTAGCCCTAGCCCATAGTCTCCC
GCTTTTATTTCTCTTAGGTCTCGGTTGTGT|GAAGATATAATAGTCTCCCAACCCCACTCT
ATTCCATGTTAAGGCCCACAGCAGTCCATC|CTCATAGGCAACGACCTTCCAGGAGCGATA
CGACCTTCCAGGAGCGATAAATTCCTCAGC|TCGTTTGACTCCTTTCGGGACACGGGAGAT
AGCAGTGGTCAGTGCTAATGTTAGTGGTAT|CTCTTAGGTCTCGGTTGTGTATTTATATAA
GAGGTATAATAGTCTCTATAATAGTCTCCC|CCTAGTGGGAACTCCTTCGTTAGCTATTGC
CCAACCCCACTCTAGCCCCGCTACGGCGAG|TAGTCTCCCAACCCCACTCTAGCCCAAGCC
ATATAATAGTCTCCCAACCCCACTCTAGCC|ACTCTCGGCCCTGCTACTAGATTTAATTAT
CAATAGGGTGCTCTTTGCCTACGAATGGAC|CCCACTCTAGCCCTCTCGCGCCGTTTCAGG
TCCTTCGTTAGCTATTGCGCAGAATTTGAC|TCTGCCTGAATGGCTCGGACCGCAGGCGGC
CGACAAGGGAATGTAGCATAGTGTGTGGAC|CTAGCCCTTGAATTCCATGTTAAGGCCCAC
CTAGCCCCCAACCCCACTCTAGCCCATGTT|GACCAGTGGTCATCAGCGTCCAACTTCCCG
CTCCCAACCCCACTCTAGCCCCCAACCCCA|ATTGCGCAGAATTTGACCAGTGGTCATCAG
CTCTAGCCCCGCTACGGCGAGCTTCTTATA|AACCCCACTCTAGCCCAAGCCCGTCCTACG
CACTCTAGCCCGAACCAGTATGGATTCATC|CTTTGCCTACGAATGGACTGGGACGGCGCT
ACATTATACATTCTACAGTAAACTCTCGGC|ATATAATAGTCTCCCAACCCCACTCTAGCC
GGTTGTGTATTTATATAATAGTCTCCCAAC|CCCACTCTAGCCCTGACTGGGATGGAAAGC
TCCCAACCCCACTCTAGCCCTTGAATTCCA|CCAACCCCACTCTAGCCCGCGGGTCTCATA
TTATACATTCTACAGTAAACTCTCGGCCCT|TAATAGTCTCCCAACCCCACTCTAGCCCCG
GAGGGATAAAGGCTCCTTAAGGTTCGGTGA|TACGTAGCAGTGGTCAGTGCTAATGTTAGT
CCCACTCTAGCCCACTTGAGAGGCCACCAA|TATTCGCCGTTTACAGGGTCAGAGGGATAA
GCTTGCGACAAGGGAATGTAGCATAGTGTG|CCACTCTAGCCCTTGAATTCCATGTTAAGG
TGCTACTAGATTTAATTATTAAGGAGGTAT|GCCATCTGGTTAGCCGGAAGAGGCCTAGTG
ATAACAGCCCAATAGGGTGCTCTTTGCCTA|TCTCCCAACCCCACTCTAGCCCTCTCGCGC
TATTTATATAATAGTCTCCCAACCCCACTC|TAGCCCTGACTGGGATGGAAAGCGGGTGTT
GGCTGCTAGGCGGAGGATGTCGCTTTTATT|AGCTCTATCAGTTGCTCACACGAAGATATA
GCTTCTTATAATAGTCTCCCAACCCCACTC|CCGTCCTACGGACTGTTAGAAGATATTCGC
TTGGGCCTTCCCCGACCACTGCTTAAGCTC|TGTGTACGGCTGCTAGGCGGAGGATGTCGC
TCGCCGTTTACAGGGTCAGAGGGATAAAGG|CCACTGCTTAAGCTCTAATACGTAGCAGTG
TCTCCCAACCCCACTCTAGCCCCGCCATCT|CAATCAGATGGGATGCACTAATGATACCTT
GACTGGGATGGAAAGCGGGTGTTTCAGGTT|AGGAGGTATAATAGTCTCTATAATAGTCTC
AACATTATACATTCTACAGTAAACTCTCGG|GATATAATAGTCTCCCAACCCCACTCTAGC
CAGGCTGACTTGGGCCTTCCCCGACCACTG|AGTCCATCTTGTGTACGGCTGCTAGGCGGA
GCGCAGAATTTGACCAGTGGTCATCAGCGT|GGACCGCAGGCGGCCACCGGGAACTATAAT
TAGGCAACGACCTTCCAGGAGCGATAAATT|TCGCGAGTCGTTTGACTCCTTTCGGGACAC
AACTCTCGGCCCTGCTACTAGATTTAATTA|CACTCTAGCCCCGCCATCTGGTTAGCCGGA
AGATATAATAGTCTCCCAACCCCACTCTAG|AAACTCTCGGCCCTGCTACTAGATTTAATT
GTTAGCTATTGCGCAGAATTTGACCAGTGG|TGAATGGCTCGGACCGCAGGCGGCCACCGG
CTTTTCAACTTTCTTGGTCCGGATCATAGG|TTTGTTATATATAATAGTCTCCCAACCCCA
GGTCTCGGTTGTGTATTTATATAATAGTCT|CCCAACCCCACTCTAGCCCTGACTGGGATG
TTATATATAATAGTCTCCCAACCCCACTCT|GCCGAAGAGCCACGGCTACAGAATACCAAT
GAGGTGGCAAATTAGAGTCGCCGAAGAGCC|AGAGGCCACCAAATATAATAGTCTCCCAAC
TGCGTGGCAGTAAGGCTTGCGACAAGGGAA|ATAGTCTCCCAACCCCACTCTAGCCCTTGA
ACTGGGACGGCGCTGCGAAATTTGTTATAT|GGTGTGAGGTGGCAAATTAGAGTCGCCGAA
TAATAGTCTCCCAACCCCACTCTAGCCCAC|CGGACTGTTAGAAGATATTCGCCGTTTACA
GTCATCTATAACAGCCCAATAGGGTGCTCT|CCCATAGTCTCCCAACCCCACTCTAGCCCT
CCTCAGCTCTATCAGTTGCTCACACGAAGA|GGGAGATAACATTATACATTCTACAGTAAA
TCTCGGTTGTGTATTTATATAATAGTCTCC|CAACCCCACTCTAGCCCTGACTGGGATGGA
AGGTGGCAAATTAGAGTCGCCGAAGAGCCA|GAGGCCACCAAATATAATAGTCTCCCAACC
GGGTCTCATAGGCAACGACCTTCCAGGAGC|TTGCCAGATCGCGAGTCGTTTGACTCCTTT
GGCCTAGTGGGAACTCCTTCGTTAGCTATT|CATAGACCATGCCTTCTGCCTGAATGGCTC
TAGTCTCCCAACCCCACTCTAGCCCAAGCC|ACAAGGGAATGTAGCATAGTGTGTGGACTG
TTCCCCGACCACTGCTTAAGCTCTAATACG|GGCTGCTAGGCGGAGGATGTCGCTTTTATT
CTCCCAACCCCACTCTAGCCCTGACTGGGA|CTGCTACTAGATTTAATTATTAAGGAGGTA
AAATTTGTTATATATAATAGTCTCCCAACC|TAGAGTCGCCGAAGAGCCACGGCTACAGAA
CCCCACTCTAGCCCGAACCAGTATGGATTC|GCTCTTTGCCTACGAATGGACTGGGACGGC
GCCCAAGCCCGTCCTACGGACTGTTAGAAG|TGTGGACTGGCAGGCTGACTTGGGCCTTCC
CTCCTTTCGGGACACGGGAGATAACATTAT|CCACTCTAGCCCATGTTGACATGATATAAT
ATATTCGCCGTTTACAGGGTCAGAGGGATA|CCGACCACTGCTTAAGCTCTAATACGTAGC
CTTCTTATAATAGTCTCCCAACCCCACTCT|CGTCCTACGGACTGTTAGAAGATATTCGCC
CCCTTGAATTCCATGTTAAGGCCCACAGCA|CGCGGGTCTCATAGGCAACGACCTTCCAGG
ATGGACTGGGACGGCGCTGCGAAATTTGTT|TTCAGGTGTGAGGTGGCAAATTAGAGTCGC
TATATAATAGTCTCCCAACCCCACTCTATA|GAAGAGCCACGGCTACAGAATACCAATATA
CCCATAGTCTCCCAACCCCACTCTAGCCCT|TACGGCGAGCTTCTTATAATAGTCTCCCAA
TCCCAACCCCACTCTAGCCCCCAACCCCAC|TTGCGCAGAATTTGACCAGTGGTCATCAGC
GACCTTCCAGGAGCGATAAATTCCTCAGCT|CGTTTGACTCCTTTCGGGACACGGGAGATA
CTGCTAGGCGGAGGATGTCGCTTTTATTTC|CTCTATCAGTTGCTCACACGAAGATATAAT
TTAGCTATTGCGCAGAATTTGACCAGTGGT|GAATGGCTCGGACCGCAGGCGGCCACCGGG
CCCCGCCATCTGGTTAGCCGGAAGAGGCCT|AATGATACCTTCCTTCAGATTTTTACATAG
AGGAGCGATAAATTCCTCAGCTCTATCAGT|TCCTTTCGGGACACGGGAGATAACATTATA
AAGGCCCACAGCAGTCCATCTTGTGTACGG|ACGACCTTCCAGGAGCGATAAATTCCTCAG
TGACTGGGATGGAAAGCGGGTGTTTCAGGT|AAGGAGGTATAATAGTCTCTATAATAGTCT
TGCTAGGCGGAGGATGTCGCTTTTATTTCT|TCTATCAGTTGCTCACACGAAGATATAATA
ACGTAGCAGTGGTCAGTGCTAATGTTAGTG|ATTTCTCTTAGGTCTCGGTTGTGTATTTAT
GTTATATATAATAGTCTCCCAACCCCACTC|CGCCGAAGAGCCACGGCTACAGAATACCAA
CAAATTAGAGTCGCCGAAGAGCCACGGCTA|ACCAAATATAATAGTCTCCCAACCCCACTC
TCACACGAAGATATAATAGTCTCCCAACCC|TCTACAGTAAACTCTCGGCCCTGCTACTAG
TGGATTCATCGACGATCTTTTCAACTTTCT|GGACGGCGCTGCGAAATTTGTTATATATAA
GTCTCCCAACCCCACTCTAGCCCTTGAATT|CTCCCAACCCCACTCTAGCCCGCGGGTCTC
AGAATTTGACCAGTGGTCATCAGCGTCCAA|CGCAGGCGGCCACCGGGAACTATAATGATG
CCAACCCCACTCTAGCCCAAGCCCGTCCTA|AATGTAGCATAGTGTGTGGACTGGCAGGCT
ATGATATAATAGTCTCCCAACCCCACTCTA|GATTAACATTGGCAATCAGATGGGATGCAC
GCCGTTTCAGGTGTGAGGTGGCAAATTAGA|CTCTAGCCCACTTGAGAGGCCACCAAATAT
CCCCACTCTAGCCCTTGAATTCCATGTTAA|CCACTCTAGCCCGCGGGTCTCATAGGCAAC
ATAGTCTCCCAACCCCACTCTAGCCCCCAA|TAGCTATTGCGCAGAATTTGACCAGTGGTC
ATAGGTGCCGGTATAATAGTCTCCCAACCC|CCCCACTCTATAATAGTCTCCCAACCCCAC
GCCCCGCCATCTGGTTAGCCGGAAGAGGCC|TAATGATACCTTCCTTCAGATTTTTACATA
GGTTAGCCGGAAGAGGCCTAGTGGGAACTC|CCTTCAGATTTTTACATAGACCATGCCTTC
AGTCGCCGAAGAGCCACGGCTACAGAATAC|TAATAGTCTCCCAACCCCACTCTAGCCCAC
CCAACCCCACTCTAGCCCACTTGAGAGGCC|GAAGATATTCGCCGTTTACAGGGTCAGAGG
GTCTCCCAACCCCACTCTAGCCCGCGGGTC|GATGGAAAGCGGGTGTTTCAGGTTATTGCC
CATCGACGATCTTTTCAACTTTCTTGGTCC|CGCTGCGAAATTTGTTATATATAATAGTCT
CCATCTGGTTAGCCGGAAGAGGCCTAGTGG|TACCTTCCTTCAGATTTTTACATAGACCAT
TAGTGGGAACTCCTTCGTTAGCTATTGCGC|GACCATGCCTTCTGCCTGAATGGCTCGGAC
ACGGCGAGCTTCTTATAATAGTCTCCCAAC|CCCAAGCCCGTCCTACGGACTGTTAGAAGA
ATAGGCAACGACCTTCCAGGAGCGATAAAT|ATCGCGAGTCGTTTGACTCCTTTCGGGACA
CCGTTTACAGGGTCAGAGGGATAAAGGCTC|CTGCTTAAGCTCTAATACGTAGCAGTGGTC
GGCCACCAAATATAATAGTCTCCCAACCCC|GAGGGATAAAGGCTCCTTAAGGTTCGGTGA
CCGCTACGGCGAGCTTCTTATAATAGTCTC|TCTAGCCCAAGCCCGTCCTACGGACTGTTA
GGCGAGCTTCTTATAATAGTCTCCCAACCC|CAAGCCCGTCCTACGGACTGTTAGAAGATA
TGGCAGGCTGACTTGGGCCTTCCCCGACCA|AGCAGTCCATCTTGTGTACGGCTGCTAGGC
GGGACACGGGAGATAACATTATACATTCTA|GCCCATGTTGACATGATATAATAGTCTCCC
TATAATAGTCTCCCAACCCCACTCTAGCCC|TAATAGTCTCCCAACCCCACTCTAGCCCGC
GTCTCGGTTGTGTATTTATATAATAGTCTC|CCAACCCCACTCTAGCCCTGACTGGGATGG
GGTGCTCTTTGCCTACGAATGGACTGGGAC|CTAGCCCTCTCGCGCCGTTTCAGGTGTGAG
CACTCTAGCCCTTGAATTCCATGTTAAGGC|CTCTAGCCCGCGGGTCTCATAGGCAACGAC
AGGTCTCGGTTGTGTATTTATATAATAGTC|TCCCAACCCCACTCTAGCCCTGACTGGGAT
TTCTACAGTAAACTCTCGGCCCTGCTACTA|CTCCCAACCCCACTCTAGCCCCGCCATCTG
GTTGTGTATTTATATAATAGTCTCCCAACC|CCACTCTAGCCCTGACTGGGATGGAAAGCG
AGAGGCCACCAAATATAATAGTCTCCCAAC|TCAGAGGGATAAAGGCTCCTTAAGGTTCGG
CCCGTCCTACGGACTGTTAGAAGATATTCG|TGGCAGGCTGACTTGGGCCTTCCCCGACCA
CTGGGACGGCGCTGCGAAATTTGTTATATA|GTGTGAGGTGGCAAATTAGAGTCGCCGAAG
TTCATCGACGATCTTTTCAACTTTCTTGGT|GGCGCTGCGAAATTTGTTATATATAATAGT
TAGTCTCCCAACCCCACTCTAGCCCACTTG|CTTAAGGTTCGGTGATATGCATGCGTGGCA
CGCGGGTCTCATAGGCAACGACCTTCCAGG|TTATTGCCAGATCGCGAGTCGTTTGACTCC
TTTCAACTTTCTTGGTCCGGATCATAGGTG|TGTTATATATAATAGTCTCCCAACCCCACT
TTTATATAATAGTCTCCCAACCCCACTCTA|GCCCTGACTGGGATGGAAAGCGGGTGTTTC
CTTGAGAGGCCACCAAATATAATAGTCTCC|AGGGTCAGAGGGATAAAGGCTCCTTAAGGT
TCTAGCCCACTTGAGAGGCCACCAAATATA|GCCGTTTACAGGGTCAGAGGGATAAAGGCT
ATAATAGTCTCCCAACCCCACTCTAGCCCG|ATAGTCTCCCAACCCCACTCTAGCCCTAGC
CCACTCTAGCCCTAGCCCATAGTCTCCCAA|CCACTCTAGCCCCGCTACGGCGAGCTTCTT
AATAGTCTCCCAACCCCACTCTAGCCCCCA|TTAGCTATTGCGCAGAATTTGACCAGTGGT
CCCACTCTAGCCCGTCATCTATAACAGCCC|ACTCTAGCCCTAGCCCATAGTCTCCCAACC
ATATAATAGTCTCCCAACCCCACTCTAGCC|CTGACTGGGATGGAAAGCGGGTGTTTCAGG
TCCCAACCCCACTCTAGCCCGTCATCTATA|CAACCCCACTCTAGCCCTAGCCCATAGTCT
TAACATTATACATTCTACAGTAAACTCTCG|TGATATAATAGTCTCCCAACCCCACTCTAG
TAAGCTCTAATACGTAGCAGTGGTCAGTGC|ATGTCGCTTTTATTTCTCTTAGGTCTCGGT
ACGGCTGCTAGGCGGAGGATGTCGCTTTTA|TCAGCTCTATCAGTTGCTCACACGAAGATA
AGCCGGAAGAGGCCTAGTGGGAACTCCTTC|CAGATTTTTACATAGACCATGCCTTCTGCC
GCAGTCCATCTTGTGTACGGCTGCTAGGCG|AGGAGCGATAAATTCCTCAGCTCTATCAGT
TCCTTAAGGTTCGGTGATATGCATGCGTGG|TCAGTGCTAATGTTAGTGGTATAATAGTCT
TGCTAATGTTAGTGGTATAATAGTCTCCCA|GGTTGTGTATTTATATAATAGTCTCCCAAC
TGGACTGGGACGGCGCTGCGAAATTTGTTA|TCAGGTGTGAGGTGGCAAATTAGAGTCGCC
GGCAGTAAGGCTTGCGACAAGGGAATGTAG|CTCCCAACCCCACTCTAGCCCTTGAATTCC
ATAATAGTCTCCCAACCCCACTCTAGCCCC|CTCCTATATAATAGTCTCCCAACCCCACTC
CTCTCGGCCCTGCTACTAGATTTAATTATT|CTCTAGCCCCGCCATCTGGTTAGCCGGAAG
TCCCAACCCCACTCTAGCCCAAGCCCGTCC|GGAATGTAGCATAGTGTGTGGACTGGCAGG
GTCGCTTTTATTTCTCTTAGGTCTCGGTTG|CACGAAGATATAATAGTCTCCCAACCCCAC
AGCCCAATAGGGTGCTCTTTGCCTACGAAT|CAACCCCACTCTAGCCCTCTCGCGCCGTTT
TCCCAACCCCACTCTAGCCCTGACTGGGAT|TGCTACTAGATTTAATTATTAAGGAGGTAT
GTGTTTCAGGTTATTGCCAGATCGCGAGTC|TATAATAGTCTCCCAACCCCACTCTAGCCC
CCCACTCTATAATAGTCTCCCAACCCCACT|ATACCAATATAATAGTCTCCCAACCCCACT
CTAGCCCGCGGGTCTCATAGGCAACGACCT|TTCAGGTTATTGCCAGATCGCGAGTCGTTT
CGATAAATTCCTCAGCTCTATCAGTTGCTC|TCGGGACACGGGAGATAACATTATACATTC
TATAATAGTCTCCCAACCCCACTCTAGCCC|TCGTTAGCTATTGCGCAGAATTTGACCAGT
TGGTCCGGATCATAGGTGCCGGTATAATAG|TAGTCTCCCAACCCCACTCTATAATAGTCT
GTGGTCAGTGCTAATGTTAGTGGTATAATA|TAGGTCTCGGTTGTGTATTTATATAATAGT
CTCTATCAGTTGCTCACACGAAGATATAAT|TAACATTATACATTCTACAGTAAACTCTCG
AGTATGGATTCATCGACGATCTTTTCAACT|ACTGGGACGGCGCTGCGAAATTTGTTATAT
ACCCCACTCTAGCCCGCGGGTCTCATAGGC|GCGGGTGTTTCAGGTTATTGCCAGATCGCG
CTTCGTTAGCTATTGCGCAGAATTTGACCA|TGCCTGAATGGCTCGGACCGCAGGCGGCCA
CCCCACTCTAGCCCTCTCGCGCCGTTTCAG|ATAATAGTCTCCCAACCCCACTCTAGCCCA
CTCTAGCCCCCAACCCCACTCTAGCCCATG|TTGACCAGTGGTCATCAGCGTCCAACTTCC
GACTCCTTTCGGGACACGGGAGATAACATT|CCCCACTCTAGCCCATGTTGACATGATATA
AGTCTCCCAACCCCACTCTATAATAGTCTC|ACGGCTACAGAATACCAATATAATAGTCTC
ATAGTCTCCCAACCCCACTCTAGCCCTCTC|GGCGAGCTTCTTATAATAGTCTCCCAACCC
CGAAGAGCCACGGCTACAGAATACCAATAT|TCTCCCAACCCCACTCTAGCCCACTTGTCT
GATGGAAAGCGGGTGTTTCAGGTTATTGCC|TATAATAGTCTCTATAATAGTCTCCCAACC
CCCTGCTACTAGATTTAATTATTAAGGAGG|CCCGCCATCTGGTTAGCCGGAAGAGGCCTA
CGGAAGAGGCCTAGTGGGAACTCCTTCGTT|ATTTTTACATAGACCATGCCTTCTGCCTGA
CACGGGAGATAACATTATACATTCTACAGT|ATGTTGACATGATATAATAGTCTCCCAACC
TAATACGTAGCAGTGGTCAGTGCTAATGTT|TTTTATTTCTCTTAGGTCTCGGTTGTGTAT
CTAATACGTAGCAGTGGTCAGTGCTAATGT|CTTTTATTTCTCTTAGGTCTCGGTTGTGTA
TATATAATAGTCTCCCAACCCCACTCTAGC|GCTTGCGACAAGGGAATGTAGCATAGTGTG
ATTCGCCGTTTACAGGGTCAGAGGGATAAA|GACCACTGCTTAAGCTCTAATACGTAGCAG
CCCACTCTAGCCCCGCCATCTGGTTAGCCG|GGGATGCACTAATGATACCTTCCTTCAGAT
CAACCCCACTCTAGCCCTGACTGGGATGGA|TACTAGATTTAATTATTAAGGAGGTATAAT
GAGAGGCCACCAAATATAATAGTCTCCCAA|GTCAGAGGGATAAAGGCTCCTTAAGGTTCG
GTGTGGACTGGCAGGCTGACTTGGGCCTTC|AGGCCCACAGCAGTCCATCTTGTGTACGGC
CAGCCCAATAGGGTGCTCTTTGCCTACGAA|CCAACCCCACTCTAGCCCTCTCGCGCCGTT
TCTTAGGTCTCGGTTGTGTATTTATATAAT|AGTCTCCCAACCCCACTCTAGCCCTGACTG
ATATAATAGTCTCCCAACCCCACTCTAGCC|CTTGCGACAAGGGAATGTAGCATAGTGTGT
AGAAGATATTCGCCGTTTACAGGGTCAGAG|CTTCCCCGACCACTGCTTAAGCTCTAATAC
AGCCCGTCATCTATAACAGCCCAATAGGGT|CCTAGCCCATAGTCTCCCAACCCCACTCTA
ACAGCCCAATAGGGTGCTCTTTGCCTACGA|CCCAACCCCACTCTAGCCCTCTCGCGCCGT
AGGCGGAGGATGTCGCTTTTATTTCTCTTA|TCAGTTGCTCACACGAAGATATAATAGTCT
CTAATGTTAGTGGTATAATAGTCTCCCAAC|TTGTGTATTTATATAATAGTCTCCCAACCC
AATAGTCTCCCAACCCCACTCTATAATAGT|GCCACGGCTACAGAATACCAATATAATAGT
ACTCTAGCCCTGACTGGGATGGAAAGCGGG|TTTAATTATTAAGGAGGTATAATAGTCTCT
ATCTGGTTAGCCGGAAGAGGCCTAGTGGGA|CCTTCCTTCAGATTTTTACATAGACCATGC
CTTTGCCTACGAATGGACTGGGACGGCGCT|CTCTCGCGCCGTTTCAGGTGTGAGGTGGCA
GGTTCGGTGATATGCATGCGTGGCAGTAAG|TAATGTTAGTGGTATAATAGTCTCCCAACC
CAGGAGCGATAAATTCCTCAGCTCTATCAG|CTCCTTTCGGGACACGGGAGATAACATTAT
GATAAATTCCTCAGCTCTATCAGTTGCTCA|CGGGACACGGGAGATAACATTATACATTCT
CTAGCCCAAGCCCGTCCTACGGACTGTTAG|GTGTGTGGACTGGCAGGCTGACTTGGGCCT
CAGGTGTGAGGTGGCAAATTAGAGTCGCCG|CCACTTGAGAGGCCACCAAATATAATAGTC
TACGGACTGTTAGAAGATATTCGCCGTTTA|CTGACTTGGGCCTTCCCCGACCACTGCTTA
TATAATAGTCTCCCAACCCCACTCTAGCCC|TCTCCTATATAATAGTCTCCCAACCCCACT
AGAGTCGCCGAAGAGCCACGGCTACAGAAT|TATAATAGTCTCCCAACCCCACTCTAGCCC
ACTCTAGCCCCCAACCCCACTCTAGCCCAT|TTTGACCAGTGGTCATCAGCGTCCAACTTC
AGTCTCCCAACCCCACTCTAGCCCTTGAAT|TCTCCCAACCCCACTCTAGCCCGCGGGTCT
CTCTAGCCCGAACCAGTATGGATTCATCGA|TTGCCTACGAATGGACTGGGACGGCGCTGC
TGCTTAAGCTCTAATACGTAGCAGTGGTCA|GAGGATGTCGCTTTTATTTCTCTTAGGTCT
GAGTCGTTTGACTCCTTTCGGGACACGGGA|AGCCCCCAACCCCACTCTAGCCCATGTTGA
GCGTGGCAGTAAGGCTTGCGACAAGGGAAT|TAGTCTCCCAACCCCACTCTAGCCCTTGAA
ATTAAGGAGGTATAATAGTCTCTATAATAG|AAGAGGCCTAGTGGGAACTCCTTCGTTAGC
TGTTTCAGGTTATTGCCAGATCGCGAGTCG|ATAATAGTCTCCCAACCCCACTCTAGCCCC
GAAATTTGTTATATATAATAGTCTCCCAAC|TTAGAGTCGCCGAAGAGCCACGGCTACAGA
GCGAGTCGTTTGACTCCTTTCGGGACACGG|CTAGCCCCCAACCCCACTCTAGCCCATGTT
CAACCCCACTCTAGCCCATGTTGACATGAT|GTCATCAGCGTCCAACTTCCCGGTAGATTA
CCCCACTCTAGCCCATGTTGACATGATATA|ATCAGCGTCCAACTTCCCGGTAGATTAACA
GAGGATGTCGCTTTTATTTCTCTTAGGTCT|TGCTCACACGAAGATATAATAGTCTCCCAA
AGCAGTCCATCTTGTGTACGGCTGCTAGGC|CAGGAGCGATAAATTCCTCAGCTCTATCAG
TTGCGCAGAATTTGACCAGTGGTCATCAGC|TCGGACCGCAGGCGGCCACCGGGAACTATA
TCCGGATCATAGGTGCCGGTATAATAGTCT|TCTCCCAACCCCACTCTATAATAGTCTCCC
ATAGTCTCCCAACCCCACTCTATAATAGTC|CCACGGCTACAGAATACCAATATAATAGTC
ATAATAGTCTCCCAACCCCACTCTATAATA|GAGCCACGGCTACAGAATACCAATATAATA
CCAAATATAATAGTCTCCCAACCCCACTCT|ATAAAGGCTCCTTAAGGTTCGGTGATATGC
ACCCCACTCTAGCCCTTGAATTCCATGTTA|CCCACTCTAGCCCGCGGGTCTCATAGGCAA
GCTGCTAGGCGGAGGATGTCGCTTTTATTT|GCTCTATCAGTTGCTCACACGAAGATATAA
TCTCCCAACCCCACTCTAGCCCTAGCCCAT|TCTCCCAACCCCACTCTAGCCCCGCTACGG
ATTCTACAGTAAACTCTCGGCCCTGCTACT|TCTCCCAACCCCACTCTAGCCCCGCCATCT
TCCCAACCCCACTCTAGCCCCGCTACGGCG|AATAGTCTCCCAACCCCACTCTAGCCCAAG
AGTGTGTGGACTGGCAGGCTGACTTGGGCC|TTAAGGCCCACAGCAGTCCATCTTGTGTAC
CTCTAGCCCGCGGGTCTCATAGGCAACGAC|GTTTCAGGTTATTGCCAGATCGCGAGTCGT
ATGCGTGGCAGTAAGGCTTGCGACAAGGGA|AATAGTCTCCCAACCCCACTCTAGCCCTTG
ATATAATAGTCTCCCAACCCCACTCTAGCC|GTCTCCTATATAATAGTCTCCCAACCCCAC
CGAATGGACTGGGACGGCGCTGCGAAATTT|CGTTTCAGGTGTGAGGTGGCAAATTAGAGT
CCACTCTATAATAGTCTCCCAACCCCACTC|TACCAATATAATAGTCTCCCAACCCCACTC
GTGATATGCATGCGTGGCAGTAAGGCTTGC|TAGTGGTATAATAGTCTCCCAACCCCACTC
CGGCTGCTAGGCGGAGGATGTCGCTTTTAT|CAGCTCTATCAGTTGCTCACACGAAGATAT
CCTTAAGGTTCGGTGATATGCATGCGTGGC|CAGTGCTAATGTTAGTGGTATAATAGTCTC
GTTTCAGGTTATTGCCAGATCGCGAGTCGT|TAATAGTCTCCCAACCCCACTCTAGCCCCC
CTAGCCCTCTCGCGCCGTTTCAGGTGTGAG|TCTCCCAACCCCACTCTAGCCCACTTGAGA
TAGCTATTGCGCAGAATTTGACCAGTGGTC|AATGGCTCGGACCGCAGGCGGCCACCGGGA
GTGCCGGTATAATAGTCTCCCAACCCCACT|ACTCTATAATAGTCTCCCAACCCCACTCTA
CCTGCTACTAGATTTAATTATTAAGGAGGT|CCGCCATCTGGTTAGCCGGAAGAGGCCTAG
CTGGCAGGCTGACTTGGGCCTTCCCCGACC|CAGCAGTCCATCTTGTGTACGGCTGCTAGG
GTATAATAGTCTCCCAACCCCACTCTAGCC|TAACAGCCCAATAGGGTGCTCTTTGCCTAC
ACTTGTCTCCTATATAATAGTCTCCCAACC|TGGCAGTAAGGCTTGCGACAAGGGAATGTA
TATAATAGTCTCCCAACCCCACTCTAGCCC|TATAATAGTCTCCCAACCCCACTCTAGCCC
CTAGCCCTGACTGGGATGGAAAGCGGGTGT|AATTATTAAGGAGGTATAATAGTCTCTATA
GGATGTCGCTTTTATTTCTCTTAGGTCTCG|CTCACACGAAGATATAATAGTCTCCCAACC
TCCCAACCCCACTCTAGCCCGCGGGTCTCA|GGAAAGCGGGTGTTTCAGGTTATTGCCAGA
TGACTCCTTTCGGGACACGGGAGATAACAT|ACCCCACTCTAGCCCATGTTGACATGATAT
ATTTATATAATAGTCTCCCAACCCCACTCT|AGCCCTGACTGGGATGGAAAGCGGGTGTTT
AAGGCTCCTTAAGGTTCGGTGATATGCATG|AGTGGTCAGTGCTAATGTTAGTGGTATAAT
TAATAGTCTCCCAACCCCACTCTATAATAG|AGCCACGGCTACAGAATACCAATATAATAG
CCACTCTAGCCCTGACTGGGATGGAAAGCG|GATTTAATTATTAAGGAGGTATAATAGTCT
TATGCATGCGTGGCAGTAAGGCTTGCGACA|GGTATAATAGTCTCCCAACCCCACTCTAGC
CCTTGAATTCCATGTTAAGGCCCACAGCAG|GCGGGTCTCATAGGCAACGACCTTCCAGGA
TGAGGTGGCAAATTAGAGTCGCCGAAGAGC|GAGAGGCCACCAAATATAATAGTCTCCCAA
TTCGCCGTTTACAGGGTCAGAGGGATAAAG|ACCACTGCTTAAGCTCTAATACGTAGCAGT
TAGCAGTGGTCAGTGCTAATGTTAGTGGTA|TCTCTTAGGTCTCGGTTGTGTATTTATATA
GCATAGTGTGTGGACTGGCAGGCTGACTTG|CATGTTAAGGCCCACAGCAGTCCATCTTGT
AGCCCCCAACCCCACTCTAGCCCATGTTGA|CCAGTGGTCATCAGCGTCCAACTTCCCGGT
TGACCAGTGGTCATCAGCGTCCAACTTCCC|CGGCCACCGGGAACTATAATGATGGGCACT
CGAAGATATAATAGTCTCCCAACCCCACTC|AGTAAACTCTCGGCCCTGCTACTAGATTTA
TACGTAGCAGTGGTCAGTGCTAATGTTAGT|TATTTCTCTTAGGTCTCGGTTGTGTATTTA
AATAGGGTGCTCTTTGCCTACGAATGGACT|CCACTCTAGCCCTCTCGCGCCGTTTCAGGT
TCTTTGCCTACGAATGGACTGGGACGGCGC|CCTCTCGCGCCGTTTCAGGTGTGAGGTGGC
GGATGGAAAGCGGGTGTTTCAGGTTATTGC|GTATAATAGTCTCTATAATAGTCTCCCAAC
GAACCAGTATGGATTCATCGACGATCTTTT|AATGGACTGGGACGGCGCTGCGAAATTTGT
CCTAGCCCATAGTCTCCCAACCCCACTCTA|CCCGCTACGGCGAGCTTCTTATAATAGTCT
TCCATGTTAAGGCCCACAGCAGTCCATCTT|CATAGGCAACGACCTTCCAGGAGCGATAAA
GCCAGATCGCGAGTCGTTTGACTCCTTTCG|ACCCCACTCTAGCCCCCAACCCCACTCTAG
TTCAGGTGTGAGGTGGCAAATTAGAGTCGC|GCCCACTTGAGAGGCCACCAAATATAATAG
TCTCCCAACCCCACTCTAGCCCTCTCGCGC|AGCTTCTTATAATAGTCTCCCAACCCCACT
ACTAGATTTAATTATTAAGGAGGTATAATA|TCTGGTTAGCCGGAAGAGGCCTAGTGGGAA
CAACCCCACTCTAGCCCCGCCATCTGGTTA|AGATGGGATGCACTAATGATACCTTCCTTC
CTCTTAGGTCTCGGTTGTGTATTTATATAA|TAGTCTCCCAACCCCACTCTAGCCCTGACT
TAGCCCGTCATCTATAACAGCCCAATAGGG|CCCTAGCCCATAGTCTCCCAACCCCACTCT
TACTAGATTTAATTATTAAGGAGGTATAAT|ATCTGGTTAGCCGGAAGAGGCCTAGTGGGA
CCCAACCCCACTCTAGCCCGCGGGTCTCAT|GAAAGCGGGTGTTTCAGGTTATTGCCAGAT
AGGGAATGTAGCATAGTGTGTGGACTGGCA|CCTTGAATTCCATGTTAAGGCCCACAGCAG
TCTATAATAGTCTCCCAACCCCACTCTAGC|CTTCGTTAGCTATTGCGCAGAATTTGACCA
TGCGACAAGGGAATGTAGCATAGTGTGTGG|CTCTAGCCCTTGAATTCCATGTTAAGGCCC
TGTGTGGACTGGCAGGCTGACTTGGGCCTT|AAGGCCCACAGCAGTCCATCTTGTGTACGG
CTCCCAACCCCACTCTAGCCCACTTGTCTC|AGGTTCGGTGATATGCATGCGTGGCAGTAA
CTAGCCCTTGAATTCCATGTTAAGGCCCAC|AGCCCGCGGGTCTCATAGGCAACGACCTTC
CTTAAGCTCTAATACGTAGCAGTGGTCAGT|GGATGTCGCTTTTATTTCTCTTAGGTCTCG
CTGGGATGGAAAGCGGGTGTTTCAGGTTAT|GAGGTATAATAGTCTCTATAATAGTCTCCC
ACTCTAGCCCTCTCGCGCCGTTTCAGGTGT|TAGTCTCCCAACCCCACTCTAGCCCACTTG
ACTCTCGGCCCTGCTACTAGATTTAATTAT|ACTCTAGCCCCGCCATCTGGTTAGCCGGAA
CTGGTTAGCCGGAAGAGGCCTAGTGGGAAC|TTCCTTCAGATTTTTACATAGACCATGCCT
CATAGTCTCCCAACCCCACTCTAGCCCTCT|CGGCGAGCTTCTTATAATAGTCTCCCAACC
CTAGCCCGTCATCTATAACAGCCCAATAGG|GCCCTAGCCCATAGTCTCCCAACCCCACTC
TCTAGCCCCCAACCCCACTCTAGCCCATGT|TGACCAGTGGTCATCAGCGTCCAACTTCCC
ACGAAGATATAATAGTCTCCCAACCCCACT|CAGTAAACTCTCGGCCCTGCTACTAGATTT
CAGGTTATTGCCAGATCGCGAGTCGTTTGA|AGTCTCCCAACCCCACTCTAGCCCCCAACC
TCTCCTATATAATAGTCTCCCAACCCCACT|GTAAGGCTTGCGACAAGGGAATGTAGCATA
GGTCCGGATCATAGGTGCCGGTATAATAGT|AGTCTCCCAACCCCACTCTATAATAGTCTC
AAGATATTCGCCGTTTACAGGGTCAGAGGG|TCCCCGACCACTGCTTAAGCTCTAATACGT
AAGATATAATAGTCTCCCAACCCCACTCTA|TAAACTCTCGGCCCTGCTACTAGATTTAAT
CCAAGCCCGTCCTACGGACTGTTAGAAGAT|TGGACTGGCAGGCTGACTTGGGCCTTCCCC
CCAATAGGGTGCTCTTTGCCTACGAATGGA|CCCCACTCTAGCCCTCTCGCGCCGTTTCAG
GCCCGCGGGTCTCATAGGCAACGACCTTCC|AGGTTATTGCCAGATCGCGAGTCGTTTGAC
TCTCGGCCCTGCTACTAGATTTAATTATTA|TCTAGCCCCGCCATCTGGTTAGCCGGAAGA
CTCTAGCCCACTTGTCTCCTATATAATAGT|ATGCATGCGTGGCAGTAAGGCTTGCGACAA
CCACTTGTCTCCTATATAATAGTCTCCCAA|CGTGGCAGTAAGGCTTGCGACAAGGGAATG
ATTCATCGACGATCTTTTCAACTTTCTTGG|CGGCGCTGCGAAATTTGTTATATATAATAG
GGGAACTCCTTCGTTAGCTATTGCGCAGAA|ATGCCTTCTGCCTGAATGGCTCGGACCGCA
AGGTTATTGCCAGATCGCGAGTCGTTTGAC|GTCTCCCAACCCCACTCTAGCCCCCAACCC
GCAGGCTGACTTGGGCCTTCCCCGACCACT|CAGTCCATCTTGTGTACGGCTGCTAGGCGG
ACTCTAGCCCACTTGTCTCCTATATAATAG|TATGCATGCGTGGCAGTAAGGCTTGCGACA
CCAGTATGGATTCATCGACGATCTTTTCAA|GGACTGGGACGGCGCTGCGAAATTTGTTAT
GACTGGCAGGCTGACTTGGGCCTTCCCCGA|CACAGCAGTCCATCTTGTGTACGGCTGCTA
CCACTCTAGCCCCCAACCCCACTCTAGCCC|AATTTGACCAGTGGTCATCAGCGTCCAACT
ATTAGAGTCGCCGAAGAGCCACGGCTACAG|AAATATAATAGTCTCCCAACCCCACTCTAG
TCTAGCCCGAACCAGTATGGATTCATCGAC|TGCCTACGAATGGACTGGGACGGCGCTGCG
ACCAGTGGTCATCAGCGTCCAACTTCCCGG|GCCACCGGGAACTATAATGATGGGCACTGT
ACCTTCCAGGAGCGATAAATTCCTCAGCTC|GTTTGACTCCTTTCGGGACACGGGAGATAA
GTCTCCCAACCCCACTCTAGCCCCCAACCC|CTATTGCGCAGAATTTGACCAGTGGTCATC
TCCTATATAATAGTCTCCCAACCCCACTCT|AAGGCTTGCGACAAGGGAATGTAGCATAGT
GTCAGAGGGATAAAGGCTCCTTAAGGTTCG|CTAATACGTAGCAGTGGTCAGTGCTAATGT
ACAGAATACCAATATAATAGTCTCCCAACC|CTAGCCCACTTGTCTCCTATATAATAGTCT
AGTGGGAACTCCTTCGTTAGCTATTGCGCA|ACCATGCCTTCTGCCTGAATGGCTCGGACC
AATTAGAGTCGCCGAAGAGCCACGGCTACA|CAAATATAATAGTCTCCCAACCCCACTCTA
CCCAACCCCACTCTAGCCCCGCTACGGCGA|ATAGTCTCCCAACCCCACTCTAGCCCAAGC
CCGCGGGTCTCATAGGCAACGACCTTCCAG|GTTATTGCCAGATCGCGAGTCGTTTGACTC
TAGTCTCCCAACCCCACTCTAGCCCTCTCG|GCGAGCTTCTTATAATAGTCTCCCAACCCC
CCCGACCACTGCTTAAGCTCTAATACGTAG|TGCTAGGCGGAGGATGTCGCTTTTATTTCT
CCCTGACTGGGATGGAAAGCGGGTGTTTCA|ATTAAGGAGGTATAATAGTCTCTATAATAG
GGACGGCGCTGCGAAATTTGTTATATATAA|TGAGGTGGCAAATTAGAGTCGCCGAAGAGC
TTATAATAGTCTCCCAACCCCACTCTAGCC|CTACGGACTGTTAGAAGATATTCGCCGTTT
TGGAAAGCGGGTGTTTCAGGTTATTGCCAG|TAATAGTCTCTATAATAGTCTCCCAACCCC
CCTTTCGGGACACGGGAGATAACATTATAC|ACTCTAGCCCATGTTGACATGATATAATAG
GACACGGGAGATAACATTATACATTCTACA|CCATGTTGACATGATATAATAGTCTCCCAA
TAGTCTCCCAACCCCACTCTAGCCCCGCTA|TATATAATAGTCTCCCAACCCCACTCTAGC
CGGGACACGGGAGATAACATTATACATTCT|AGCCCATGTTGACATGATATAATAGTCTCC
CACCAAATATAATAGTCTCCCAACCCCACT|GGATAAAGGCTCCTTAAGGTTCGGTGATAT
ATATAATAGTCTCCCAACCCCACTCTAGCC|AGGCTCCTTAAGGTTCGGTGATATGCATGC
TCATCTATAACAGCCCAATAGGGTGCTCTT|CCATAGTCTCCCAACCCCACTCTAGCCCTC
TTAATTATTAAGGAGGTATAATAGTCTCTA|AGCCGGAAGAGGCCTAGTGGGAACTCCTTC
ACTCTAGCCCGAACCAGTATGGATTCATCG|TTTGCCTACGAATGGACTGGGACGGCGCTG
CGCCGAAGAGCCACGGCTACAGAATACCAA|TAGTCTCCCAACCCCACTCTAGCCCACTTG
GTCTCTATAATAGTCTCCCAACCCCACTCT|CTCCTTCGTTAGCTATTGCGCAGAATTTGA
TAAGGCCCACAGCAGTCCATCTTGTGTACG|AACGACCTTCCAGGAGCGATAAATTCCTCA
TCAGTTGCTCACACGAAGATATAATAGTCT|TTATACATTCTACAGTAAACTCTCGGCCCT
ACCCCACTCTAGCCCCGCTACGGCGAGCTT|TCTCCCAACCCCACTCTAGCCCAAGCCCGT
GATATAATAGTCTCCCAACCCCACTCTAGC|AACTCTCGGCCCTGCTACTAGATTTAATTA
GCCACGGCTACAGAATACCAATATAATAGT|AACCCCACTCTAGCCCACTTGTCTCCTATA
GATGTCGCTTTTATTTCTCTTAGGTCTCGG|TCACACGAAGATATAATAGTCTCCCAACCC
CCTCTCGCGCCGTTTCAGGTGTGAGGTGGC|CAACCCCACTCTAGCCCACTTGAGAGGCCA
CAACCCCACTCTAGCCCAAGCCCGTCCTAC|ATGTAGCATAGTGTGTGGACTGGCAGGCTG
CTAGCCCATAGTCTCCCAACCCCACTCTAG|CCGCTACGGCGAGCTTCTTATAATAGTCTC
CTCCCAACCCCACTCTAGCCCAAGCCCGTC|GGGAATGTAGCATAGTGTGTGGACTGGCAG
GTTATTGCCAGATCGCGAGTCGTTTGACTC|CTCCCAACCCCACTCTAGCCCCCAACCCCA
GGTATAATAGTCTCTATAATAGTCTCCCAA|TAGTGGGAACTCCTTCGTTAGCTATTGCGC
TCCTACGGACTGTTAGAAGATATTCGCCGT|AGGCTGACTTGGGCCTTCCCCGACCACTGC
CAGTGCTAATGTTAGTGGTATAATAGTCTC|CTCGGTTGTGTATTTATATAATAGTCTCCC
CCACTCTAGCCCATGTTGACATGATATAAT|CAGCGTCCAACTTCCCGGTAGATTAACATT
CCCCACTCTAGCCCCGCTACGGCGAGCTTC|CTCCCAACCCCACTCTAGCCCAAGCCCGTC
GCAGTGGTCAGTGCTAATGTTAGTGGTATA|TCTTAGGTCTCGGTTGTGTATTTATATAAT
ACCCCACTCTATAATAGTCTCCCAACCCCA|GAATACCAATATAATAGTCTCCCAACCCCA
CCCCAACCCCACTCTAGCCCATGTTGACAT|GTGGTCATCAGCGTCCAACTTCCCGGTAGA
GCCCCGCTACGGCGAGCTTCTTATAATAGT|CACTCTAGCCCAAGCCCGTCCTACGGACTG
TTTGACCAGTGGTCATCAGCGTCCAACTTC|GGCGGCCACCGGGAACTATAATGATGGGCA
CTCTAGCCCTCTCGCGCCGTTTCAGGTGTG|AGTCTCCCAACCCCACTCTAGCCCACTTGA
TGTTATATATAATAGTCTCCCAACCCCACT|TCGCCGAAGAGCCACGGCTACAGAATACCA
AACCCCACTCTAGCCCATGTTGACATGATA|TCATCAGCGTCCAACTTCCCGGTAGATTAA
ACTCTAGCCCTAGCCCATAGTCTCCCAACC|ACTCTAGCCCCGCTACGGCGAGCTTCTTAT
ATAGTCTCCCAACCCCACTCTAGCCCGAAC|GCCCAATAGGGTGCTCTTTGCCTACGAATG
GGGTGCTCTTTGCCTACGAATGGACTGGGA|TCTAGCCCTCTCGCGCCGTTTCAGGTGTGA
AATATAATAGTCTCCCAACCCCACTCTAGC|TGTCTCCTATATAATAGTCTCCCAACCCCA
GCAGAATTTGACCAGTGGTCATCAGCGTCC|ACCGCAGGCGGCCACCGGGAACTATAATGA
GCCCACTTGTCTCCTATATAATAGTCTCCC|TGCGTGGCAGTAAGGCTTGCGACAAGGGAA
TTGGTCCGGATCATAGGTGCCGGTATAATA|ATAGTCTCCCAACCCCACTCTATAATAGTC
AGTGGTCAGTGCTAATGTTAGTGGTATAAT|TTAGGTCTCGGTTGTGTATTTATATAATAG
ATAATAGTCTCCCAACCCCACTCTAGCCCA|TGCGACAAGGGAATGTAGCATAGTGTGTGG
GCGGGTGTTTCAGGTTATTGCCAGATCGCG|TCTCTATAATAGTCTCCCAACCCCACTCTA
GTCTCCCAACCCCACTCTAGCCCGTCATCT|TCCCAACCCCACTCTAGCCCTAGCCCATAG
GATTCATCGACGATCTTTTCAACTTTCTTG|ACGGCGCTGCGAAATTTGTTATATATAATA
AGGCCTAGTGGGAACTCCTTCGTTAGCTAT|ACATAGACCATGCCTTCTGCCTGAATGGCT
AATAGTCTCCCAACCCCACTCTAGCCCCGC|CCTATATAATAGTCTCCCAACCCCACTCTA
AACCAGTATGGATTCATCGACGATCTTTTC|ATGGACTGGGACGGCGCTGCGAAATTTGTT
CTCCCAACCCCACTCTATAATAGTCTCCCA|GCTACAGAATACCAATATAATAGTCTCCCA
CCCAACCCCACTCTAGCCCTAGCCCATAGT|CCCAACCCCACTCTAGCCCCGCTACGGCGA
TACAGGGTCAGAGGGATAAAGGCTCCTTAA|TAAGCTCTAATACGTAGCAGTGGTCAGTGC
CCTACGAATGGACTGGGACGGCGCTGCGAA|GCGCCGTTTCAGGTGTGAGGTGGCAAATTA
TTGACTCCTTTCGGGACACGGGAGATAACA|AACCCCACTCTAGCCCATGTTGACATGATA
ACTTGAGAGGCCACCAAATATAATAGTCTC|CAGGGTCAGAGGGATAAAGGCTCCTTAAGG
TAAGGCTTGCGACAAGGGAATGTAGCATAG|AACCCCACTCTAGCCCTTGAATTCCATGTT
TAGCCCCCAACCCCACTCTAGCCCATGTTG|ACCAGTGGTCATCAGCGTCCAACTTCCCGG
CCGGAAGAGGCCTAGTGGGAACTCCTTCGT|GATTTTTACATAGACCATGCCTTCTGCCTG
AGATTTAATTATTAAGGAGGTATAATAGTC|GGTTAGCCGGAAGAGGCCTAGTGGGAACTC
TACCAATATAATAGTCTCCCAACCCCACTC|CACTTGTCTCCTATATAATAGTCTCCCAAC
CTTATAATAGTCTCCCAACCCCACTCTAGC|CCTACGGACTGTTAGAAGATATTCGCCGTT
GGTGCCGGTATAATAGTCTCCCAACCCCAC|CACTCTATAATAGTCTCCCAACCCCACTCT
TGGGACGGCGCTGCGAAATTTGTTATATAT|TGTGAGGTGGCAAATTAGAGTCGCCGAAGA
CACTCTAGCCCCGCTACGGCGAGCTTCTTA|CCAACCCCACTCTAGCCCAAGCCCGTCCTA
TCATCGACGATCTTTTCAACTTTCTTGGTC|GCGCTGCGAAATTTGTTATATATAATAGTC
GCCCATAGTCTCCCAACCCCACTCTAGCCC|CTACGGCGAGCTTCTTATAATAGTCTCCCA
TGACATGATATAATAGTCTCCCAACCCCAC|GGTAGATTAACATTGGCAATCAGATGGGAT
AGCGGGTGTTTCAGGTTATTGCCAGATCGC|GTCTCTATAATAGTCTCCCAACCCCACTCT
GCTGACTTGGGCCTTCCCCGACCACTGCTT|CCATCTTGTGTACGGCTGCTAGGCGGAGGA
AAACTCTCGGCCCTGCTACTAGATTTAATT|CCACTCTAGCCCCGCCATCTGGTTAGCCGG
TCTCATAGGCAACGACCTTCCAGGAGCGAT|CCAGATCGCGAGTCGTTTGACTCCTTTCGG
TCGCTTTTATTTCTCTTAGGTCTCGGTTGT|ACGAAGATATAATAGTCTCCCAACCCCACT
CTCCCAACCCCACTCTAGCCCGCGGGTCTC|TGGAAAGCGGGTGTTTCAGGTTATTGCCAG
GTCTCCCAACCCCACTCTAGCCCACTTGTC|TAAGGTTCGGTGATATGCATGCGTGGCAGT
CTCTAGCCCTAGCCCATAGTCTCCCAACCC|CTCTAGCCCCGCTACGGCGAGCTTCTTATA
AGCCCTCTCGCGCCGTTTCAGGTGTGAGGT|TCCCAACCCCACTCTAGCCCACTTGAGAGG
AGCCCATAGTCTCCCAACCCCACTCTAGCC|GCTACGGCGAGCTTCTTATAATAGTCTCCC
TAATAGTCTCCCAACCCCACTCTAGCCCCC|GTTAGCTATTGCGCAGAATTTGACCAGTGG
TAACAGCCCAATAGGGTGCTCTTTGCCTAC|CTCCCAACCCCACTCTAGCCCTCTCGCGCC
GGAGGTATAATAGTCTCTATAATAGTCTCC|GCCTAGTGGGAACTCCTTCGTTAGCTATTG
CTCCCAACCCCACTCTAGCCCTTGAATTCC|CCCAACCCCACTCTAGCCCGCGGGTCTCAT
CTCCTTAAGGTTCGGTGATATGCATGCGTG|GTCAGTGCTAATGTTAGTGGTATAATAGTC
CTATTGCGCAGAATTTGACCAGTGGTCATC|GGCTCGGACCGCAGGCGGCCACCGGGAACT
TGGTTAGCCGGAAGAGGCCTAGTGGGAACT|TCCTTCAGATTTTTACATAGACCATGCCTT
TAAGGAGGTATAATAGTCTCTATAATAGTC|GAGGCCTAGTGGGAACTCCTTCGTTAGCTA
AACCCCACTCTAGCCCTAGCCCATAGTCTC|AACCCCACTCTAGCCCCGCTACGGCGAGCT
CTCTAGCCCTTGAATTCCATGTTAAGGCCC|CTAGCCCGCGGGTCTCATAGGCAACGACCT
AAATTCCTCAGCTCTATCAGTTGCTCACAC|GACACGGGAGATAACATTATACATTCTACA
CCCAAGCCCGTCCTACGGACTGTTAGAAGA|GTGGACTGGCAGGCTGACTTGGGCCTTCCC
TAATAGTCTCCCAACCCCACTCTAGCCCCG|CATTGGCAATCAGATGGGATGCACTAATGA
TAGCCCTCTCGCGCCGTTTCAGGTGTGAGG|CTCCCAACCCCACTCTAGCCCACTTGAGAG
AGGCCCACAGCAGTCCATCTTGTGTACGGC|CGACCTTCCAGGAGCGATAAATTCCTCAGC
CCCGTCATCTATAACAGCCCAATAGGGTGC|TAGCCCATAGTCTCCCAACCCCACTCTAGC
TCTCCCAACCCCACTCTAGCCCACTTGAGA|GTTAGAAGATATTCGCCGTTTACAGGGTCA
TATAATAGTCTCCCAACCCCACTCTAGCCC|AACATTGGCAATCAGATGGGATGCACTAAT
TTGAGAGGCCACCAAATATAATAGTCTCCC|GGGTCAGAGGGATAAAGGCTCCTTAAGGTT
AGTCTCCCAACCCCACTCTAGCCCTGACTG|GCCCTGCTACTAGATTTAATTATTAAGGAG
CGCAGAATTTGACCAGTGGTCATCAGCGTC|GACCGCAGGCGGCCACCGGGAACTATAATG
TGTCGCTTTTATTTCTCTTAGGTCTCGGTT|ACACGAAGATATAATAGTCTCCCAACCCCA
GCCCGTCCTACGGACTGTTAGAAGATATTC|CTGGCAGGCTGACTTGGGCCTTCCCCGACC
TATAATAGTCTCCCAACCCCACTCTAGCCC|GGCTCCTTAAGGTTCGGTGATATGCATGCG
CCCAACCCCACTCTAGCCCATGTTGACATG|TGGTCATCAGCGTCCAACTTCCCGGTAGAT
CTACAGAATACCAATATAATAGTCTCCCAA|CTCTAGCCCACTTGTCTCCTATATAATAGT
AGTCTCTATAATAGTCTCCCAACCCCACTC|ACTCCTTCGTTAGCTATTGCGCAGAATTTG
CACGAAGATATAATAGTCTCCCAACCCCAC|ACAGTAAACTCTCGGCCCTGCTACTAGATT
AGCATAGTGTGTGGACTGGCAGGCTGACTT|CCATGTTAAGGCCCACAGCAGTCCATCTTG
GACTTGGGCCTTCCCCGACCACTGCTTAAG|TCTTGTGTACGGCTGCTAGGCGGAGGATGT
CTATCAGTTGCTCACACGAAGATATAATAG|ACATTATACATTCTACAGTAAACTCTCGGC
AAAGGCTCCTTAAGGTTCGGTGATATGCAT|CAGTGGTCAGTGCTAATGTTAGTGGTATAA
ATTTAATTATTAAGGAGGTATAATAGTCTC|TTAGCCGGAAGAGGCCTAGTGGGAACTCCT
AGCCACGGCTACAGAATACCAATATAATAG|CAACCCCACTCTAGCCCACTTGTCTCCTAT
CCAGGAGCGATAAATTCCTCAGCTCTATCA|ACTCCTTTCGGGACACGGGAGATAACATTA
AGCCCGAACCAGTATGGATTCATCGACGAT|CTACGAATGGACTGGGACGGCGCTGCGAAA
TAGTCTCCCAACCCCACTCTAGCCCTAGCC|TAGTCTCCCAACCCCACTCTAGCCCCGCTA
AACCCCACTCTATAATAGTCTCCCAACCCC|AGAATACCAATATAATAGTCTCCCAACCCC
TATAATAGTCTCCCAACCCCACTCTAGCCC|AATAGTCTCCCAACCCCACTCTAGCCCTAG
ATGTAGCATAGTGTGTGGACTGGCAGGCTG|AATTCCATGTTAAGGCCCACAGCAGTCCAT
CCCCACTCTAGCCCGCGGGTCTCATAGGCA|CGGGTGTTTCAGGTTATTGCCAGATCGCGA
ATTGCCAGATCGCGAGTCGTTTGACTCCTT|CCAACCCCACTCTAGCCCCCAACCCCACTC
CCCCACTCTATAATAGTCTCCCAACCCCAC|AATACCAATATAATAGTCTCCCAACCCCAC
TCTATCAGTTGCTCACACGAAGATATAATA|AACATTATACATTCTACAGTAAACTCTCGG
CCAACCCCACTCTAGCCCCGCCATCTGGTT|CAGATGGGATGCACTAATGATACCTTCCTT
CGCTACGGCGAGCTTCTTATAATAGTCTCC|CTAGCCCAAGCCCGTCCTACGGACTGTTAG
TTAAGCTCTAATACGTAGCAGTGGTCAGTG|GATGTCGCTTTTATTTCTCTTAGGTCTCGG
TATAATAGTCTCTATAATAGTCTCCCAACC|GTGGGAACTCCTTCGTTAGCTATTGCGCAG
TATTCGCCGTTTACAGGGTCAGAGGGATAA|CGACCACTGCTTAAGCTCTAATACGTAGCA
CTGACTTGGGCCTTCCCCGACCACTGCTTA|CATCTTGTGTACGGCTGCTAGGCGGAGGAT
ATGTTAAGGCCCACAGCAGTCCATCTTGTG|AGGCAACGACCTTCCAGGAGCGATAAATTC
ACTCTAGCCCACTTGAGAGGCCACCAAATA|TCGCCGTTTACAGGGTCAGAGGGATAAAGG
CAATATAATAGTCTCCCAACCCCACTCTAG|TTGTCTCCTATATAATAGTCTCCCAACCCC
CTCTAGCCCGTCATCTATAACAGCCCAATA|TAGCCCTAGCCCATAGTCTCCCAACCCCAC
CAGAATACCAATATAATAGTCTCCCAACCC|TAGCCCACTTGTCTCCTATATAATAGTCTC
TATACATTCTACAGTAAACTCTCGGCCCTG|AATAGTCTCCCAACCCCACTCTAGCCCCGC
ATAATAGTCTCCCAACCCCACTCTAGCCCT|ATAATAGTCTCCCAACCCCACTCTAGCCCC
ATAGTGTGTGGACTGGCAGGCTGACTTGGG|TGTTAAGGCCCACAGCAGTCCATCTTGTGT
TTCGTTAGCTATTGCGCAGAATTTGACCAG|GCCTGAATGGCTCGGACCGCAGGCGGCCAC
CTCAGCTCTATCAGTTGCTCACACGAAGAT|GGAGATAACATTATACATTCTACAGTAAAC
TAATAGTCTCCCAACCCCACTCTAGCCCAA|GCGACAAGGGAATGTAGCATAGTGTGTGGA
TTAAGGAGGTATAATAGTCTCTATAATAGT|AGAGGCCTAGTGGGAACTCCTTCGTTAGCT
TAATAGTCTCCCAACCCCACTCTAGCCCTG|CTCGGCCCTGCTACTAGATTTAATTATTAA
CAACCCCACTCTAGCCCTAGCCCATAGTCT|CAACCCCACTCTAGCCCCGCTACGGCGAGC
CGTTTCAGGTGTGAGGTGGCAAATTAGAGT|CTAGCCCACTTGAGAGGCCACCAAATATAA
TTCGGGACACGGGAGATAACATTATACATT|CTAGCCCATGTTGACATGATATAATAGTCT
TGGTATAATAGTCTCCCAACCCCACTCTAG|ATATAATAGTCTCCCAACCCCACTCTAGCC
GTTAGTGGTATAATAGTCTCCCAACCCCAC|TATTTATATAATAGTCTCCCAACCCCACTC
CCAACCCCACTCTAGCCCGCGGGTCTCATA|AAAGCGGGTGTTTCAGGTTATTGCCAGATC
CCAACCCCACTCTAGCCCGTCATCTATAAC|ACCCCACTCTAGCCCTAGCCCATAGTCTCC
TAGTCTCCCAACCCCACTCTATAATAGTCT|CACGGCTACAGAATACCAATATAATAGTCT
CAAGCCCGTCCTACGGACTGTTAGAAGATA|GGACTGGCAGGCTGACTTGGGCCTTCCCCG
TATGGATTCATCGACGATCTTTTCAACTTT|TGGGACGGCGCTGCGAAATTTGTTATATAT
TCTGGTTAGCCGGAAGAGGCCTAGTGGGAA|CTTCCTTCAGATTTTTACATAGACCATGCC
GGGTCAGAGGGATAAAGGCTCCTTAAGGTT|CTCTAATACGTAGCAGTGGTCAGTGCTAAT
AATTTGTTATATATAATAGTCTCCCAACCC|AGAGTCGCCGAAGAGCCACGGCTACAGAAT
AATAGTCTCTATAATAGTCTCCCAACCCCA|GGAACTCCTTCGTTAGCTATTGCGCAGAAT
GTATAATAGTCTCTATAATAGTCTCCCAAC|AGTGGGAACTCCTTCGTTAGCTATTGCGCA
ACCCCACTCTAGCCCGTCATCTATAACAGC|CCACTCTAGCCCTAGCCCATAGTCTCCCAA
TTGTCTCCTATATAATAGTCTCCCAACCCC|GCAGTAAGGCTTGCGACAAGGGAATGTAGC
TAGCCCATGTTGACATGATATAATAGTCTC|CCAACTTCCCGGTAGATTAACATTGGCAAT
AATACGTAGCAGTGGTCAGTGCTAATGTTA|TTTATTTCTCTTAGGTCTCGGTTGTGTATT
GGTGGCAAATTAGAGTCGCCGAAGAGCCAC|AGGCCACCAAATATAATAGTCTCCCAACCC
CCCGAACCAGTATGGATTCATCGACGATCT|ACGAATGGACTGGGACGGCGCTGCGAAATT
CCGAACCAGTATGGATTCATCGACGATCTT|CGAATGGACTGGGACGGCGCTGCGAAATTT
ACCCCACTCTAGCCCTAGCCCATAGTCTCC|ACCCCACTCTAGCCCCGCTACGGCGAGCTT
TCGGCCCTGCTACTAGATTTAATTATTAAG|TAGCCCCGCCATCTGGTTAGCCGGAAGAGG
ATAGTCTCCCAACCCCACTCTAGCCCGTCA|GTCTCCCAACCCCACTCTAGCCCTAGCCCA
ATAGGGTGCTCTTTGCCTACGAATGGACTG|CACTCTAGCCCTCTCGCGCCGTTTCAGGTG
CTGCTTAAGCTCTAATACGTAGCAGTGGTC|GGAGGATGTCGCTTTTATTTCTCTTAGGTC
GTTCGGTGATATGCATGCGTGGCAGTAAGG|AATGTTAGTGGTATAATAGTCTCCCAACCC
TCTATAATAGTCTCCCAACCCCACTCTAGC|AATATAATAGTCTCCCAACCCCACTCTAGC
TGCGCAGAATTTGACCAGTGGTCATCAGCG|CGGACCGCAGGCGGCCACCGGGAACTATAA
TAATAGTCTCCCAACCCCACTCTAGCCCGT|TAGTCTCCCAACCCCACTCTAGCCCTAGCC
ACTCTATAATAGTCTCCCAACCCCACTCTA|CCAATATAATAGTCTCCCAACCCCACTCTA
CTGACTGGGATGGAAAGCGGGTGTTTCAGG|TAAGGAGGTATAATAGTCTCTATAATAGTC
GTCGTTTGACTCCTTTCGGGACACGGGAGA|CCCCCAACCCCACTCTAGCCCATGTTGACA
GTGTGTGGACTGGCAGGCTGACTTGGGCCT|TAAGGCCCACAGCAGTCCATCTTGTGTACG
AGAGGGATAAAGGCTCCTTAAGGTTCGGTG|ATACGTAGCAGTGGTCAGTGCTAATGTTAG
CCCCGCTACGGCGAGCTTCTTATAATAGTC|ACTCTAGCCCAAGCCCGTCCTACGGACTGT
CCAACCCCACTCTAGCCCTAGCCCATAGTC|CCAACCCCACTCTAGCCCCGCTACGGCGAG
GCAAATTAGAGTCGCCGAAGAGCCACGGCT|CACCAAATATAATAGTCTCCCAACCCCACT
TGCTCACACGAAGATATAATAGTCTCCCAA|CATTCTACAGTAAACTCTCGGCCCTGCTAC
AGGAGGTATAATAGTCTCTATAATAGTCTC|GGCCTAGTGGGAACTCCTTCGTTAGCTATT
AAATATAATAGTCTCCCAACCCCACTCTAG|AAAGGCTCCTTAAGGTTCGGTGATATGCAT
TGTACGGCTGCTAGGCGGAGGATGTCGCTT|TCCTCAGCTCTATCAGTTGCTCACACGAAG
GAACTCCTTCGTTAGCTATTGCGCAGAATT|GCCTTCTGCCTGAATGGCTCGGACCGCAGG
CTTGGGCCTTCCCCGACCACTGCTTAAGCT|TTGTGTACGGCTGCTAGGCGGAGGATGTCG
CTCTATAATAGTCTCCCAACCCCACTCTAG|CCTTCGTTAGCTATTGCGCAGAATTTGACC
GGGACGGCGCTGCGAAATTTGTTATATATA|GTGAGGTGGCAAATTAGAGTCGCCGAAGAG
CAACCCCACTCTAGCCCCCAACCCCACTCT|CGCAGAATTTGACCAGTGGTCATCAGCGTC
ATAATAGTCTCCCAACCCCACTCTAGCCCT|AATAGTCTCCCAACCCCACTCTAGCCCGCG
AAGAGCCACGGCTACAGAATACCAATATAA|TCCCAACCCCACTCTAGCCCACTTGTCTCC
TCTAGCCCGTCATCTATAACAGCCCAATAG|AGCCCTAGCCCATAGTCTCCCAACCCCACT
CACTCTAGCCCTCTCGCGCCGTTTCAGGTG|ATAGTCTCCCAACCCCACTCTAGCCCACTT
CGGAGGATGTCGCTTTTATTTCTCTTAGGT|GTTGCTCACACGAAGATATAATAGTCTCCC
TTGCTCACACGAAGATATAATAGTCTCCCA|ACATTCTACAGTAAACTCTCGGCCCTGCTA
ACCACTGCTTAAGCTCTAATACGTAGCAGT|AGGCGGAGGATGTCGCTTTTATTTCTCTTA
ATGCATGCGTGGCAGTAAGGCTTGCGACAA|GTATAATAGTCTCCCAACCCCACTCTAGCC
TCGGGACACGGGAGATAACATTATACATTC|TAGCCCATGTTGACATGATATAATAGTCTC
ATAGTCTCCCAACCCCACTCTAGCCCAAGC|GACAAGGGAATGTAGCATAGTGTGTGGACT
GGTCAGTGCTAATGTTAGTGGTATAATAGT|GGTCTCGGTTGTGTATTTATATAATAGTCT
ACTCTAGCCCAAGCCCGTCCTACGGACTGT|ATAGTGTGTGGACTGGCAGGCTGACTTGGG
TATAATAGTCTCCCAACCCCACTCTAGCCC|CTCTCGGCCCTGCTACTAGATTTAATTATT
GGTGATATGCATGCGTGGCAGTAAGGCTTG|TTAGTGGTATAATAGTCTCCCAACCCCACT
CTAGCCCTAGCCCATAGTCTCCCAACCCCA|CTAGCCCCGCTACGGCGAGCTTCTTATAAT
AGCTATTGCGCAGAATTTGACCAGTGGTCA|ATGGCTCGGACCGCAGGCGGCCACCGGGAA
AGGTATAATAGTCTCCCAACCCCACTCTAG|TATAACAGCCCAATAGGGTGCTCTTTGCCT
GCCGGAAGAGGCCTAGTGGGAACTCCTTCG|AGATTTTTACATAGACCATGCCTTCTGCCT
CCACTTGAGAGGCCACCAAATATAATAGTC|TACAGGGTCAGAGGGATAAAGGCTCCTTAA
ATACATTCTACAGTAAACTCTCGGCCCTGC|ATAGTCTCCCAACCCCACTCTAGCCCCGCC
AGGCTGACTTGGGCCTTCCCCGACCACTGC|GTCCATCTTGTGTACGGCTGCTAGGCGGAG
CTCCTATATAATAGTCTCCCAACCCCACTC|TAAGGCTTGCGACAAGGGAATGTAGCATAG
AGGTGCCGGTATAATAGTCTCCCAACCCCA|CCACTCTATAATAGTCTCCCAACCCCACTC
GGTTATTGCCAGATCGCGAGTCGTTTGACT|TCTCCCAACCCCACTCTAGCCCCCAACCCC
ACCCCACTCTAGCCCAAGCCCGTCCTACGG|GTAGCATAGTGTGTGGACTGGCAGGCTGAC
GCGGGTCTCATAGGCAACGACCTTCCAGGA|TATTGCCAGATCGCGAGTCGTTTGACTCCT
ATAGTCTCCCAACCCCACTCTAGCCCTTGA|AGTCTCCCAACCCCACTCTAGCCCGCGGGT
AACCCCACTCTAGCCCACTTGAGAGGCCAC|AGATATTCGCCGTTTACAGGGTCAGAGGGA
GGTATAATAGTCTCCCAACCCCACTCTAGC|ATAACAGCCCAATAGGGTGCTCTTTGCCTA
GGACTGGGACGGCGCTGCGAAATTTGTTAT|CAGGTGTGAGGTGGCAAATTAGAGTCGCCG
TGGGAACTCCTTCGTTAGCTATTGCGCAGA|CATGCCTTCTGCCTGAATGGCTCGGACCGC
CCCAACCCCACTCTAGCCCACTTGTCTCCT|GTTCGGTGATATGCATGCGTGGCAGTAAGG
CGGATCATAGGTGCCGGTATAATAGTCTCC|TCCCAACCCCACTCTATAATAGTCTCCCAA
TAGCCCAAGCCCGTCCTACGGACTGTTAGA|TGTGTGGACTGGCAGGCTGACTTGGGCCTT
TGGGATGGAAAGCGGGTGTTTCAGGTTATT|AGGTATAATAGTCTCTATAATAGTCTCCCA
ACACGAAGATATAATAGTCTCCCAACCCCA|TACAGTAAACTCTCGGCCCTGCTACTAGAT
CGTTTGACTCCTTTCGGGACACGGGAGATA|CCCAACCCCACTCTAGCCCATGTTGACATG
CCCCACTCTAGCCCAAGCCCGTCCTACGGA|TAGCATAGTGTGTGGACTGGCAGGCTGACT
CTCTTTGCCTACGAATGGACTGGGACGGCG|CCCTCTCGCGCCGTTTCAGGTGTGAGGTGG
GCTGCGAAATTTGTTATATATAATAGTCTC|GCAAATTAGAGTCGCCGAAGAGCCACGGCT
GAGATAACATTATACATTCTACAGTAAACT|GACATGATATAATAGTCTCCCAACCCCACT
CACTCTAGCCCCGCCATCTGGTTAGCCGGA|GATGCACTAATGATACCTTCCTTCAGATTT
TAGCCCTTGAATTCCATGTTAAGGCCCACA|GCCCGCGGGTCTCATAGGCAACGACCTTCC
CTCCCAACCCCACTCTAGCCCGAACCAGTA|ATAGGGTGCTCTTTGCCTACGAATGGACTG
CCCAACCCCACTCTAGCCCCCAACCCCACT|TGCGCAGAATTTGACCAGTGGTCATCAGCG
AACCCCACTCTAGCCCGAACCAGTATGGAT|GTGCTCTTTGCCTACGAATGGACTGGGACG
TGTGGACTGGCAGGCTGACTTGGGCCTTCC|GGCCCACAGCAGTCCATCTTGTGTACGGCT
GACTGGGACGGCGCTGCGAAATTTGTTATA|AGGTGTGAGGTGGCAAATTAGAGTCGCCGA
TTGACATGATATAATAGTCTCCCAACCCCA|CGGTAGATTAACATTGGCAATCAGATGGGA
AGCCCATGTTGACATGATATAATAGTCTCC|CAACTTCCCGGTAGATTAACATTGGCAATC
TGAGAGGCCACCAAATATAATAGTCTCCCA|GGTCAGAGGGATAAAGGCTCCTTAAGGTTC
GTGGCAAATTAGAGTCGCCGAAGAGCCACG|GGCCACCAAATATAATAGTCTCCCAACCCC
TAAATTCCTCAGCTCTATCAGTTGCTCACA|GGACACGGGAGATAACATTATACATTCTAC
GGCGGAGGATGTCGCTTTTATTTCTCTTAG|CAGTTGCTCACACGAAGATATAATAGTCTC
CGACGATCTTTTCAACTTTCTTGGTCCGGA|TGCGAAATTTGTTATATATAATAGTCTCCC
ACTCTAGCCCCGCTACGGCGAGCTTCTTAT|CAACCCCACTCTAGCCCAAGCCCGTCCTAC
GATATTCGCCGTTTACAGGGTCAGAGGGAT|CCCGACCACTGCTTAAGCTCTAATACGTAG
GGAACTCCTTCGTTAGCTATTGCGCAGAAT|TGCCTTCTGCCTGAATGGCTCGGACCGCAG
TAAACTCTCGGCCCTGCTACTAGATTTAAT|CCCACTCTAGCCCCGCCATCTGGTTAGCCG
CTAGTGGGAACTCCTTCGTTAGCTATTGCG|AGACCATGCCTTCTGCCTGAATGGCTCGGA
AGATATTCGCCGTTTACAGGGTCAGAGGGA|CCCCGACCACTGCTTAAGCTCTAATACGTA
CACTTGAGAGGCCACCAAATATAATAGTCT|ACAGGGTCAGAGGGATAAAGGCTCCTTAAG
CCACTCTAGCCCGTCATCTATAACAGCCCA|CTCTAGCCCTAGCCCATAGTCTCCCAACCC
CAACCCCACTCTAGCCCTTGAATTCCATGT|ACCCCACTCTAGCCCGCGGGTCTCATAGGC
ACTCTAGCCCTTGAATTCCATGTTAAGGCC|TCTAGCCCGCGGGTCTCATAGGCAACGACC
CAGTGGTCAGTGCTAATGTTAGTGGTATAA|CTTAGGTCTCGGTTGTGTATTTATATAATA
TAATAGTCTCCCAACCCCACTCTAGCCCCG|TCCTATATAATAGTCTCCCAACCCCACTCT
CAGATCGCGAGTCGTTTGACTCCTTTCGGG|CCCACTCTAGCCCCCAACCCCACTCTAGCC
GCTTAAGCTCTAATACGTAGCAGTGGTCAG|AGGATGTCGCTTTTATTTCTCTTAGGTCTC
GTTGACATGATATAATAGTCTCCCAACCCC|CCGGTAGATTAACATTGGCAATCAGATGGG
CAACCCCACTCTAGCCCCGCTACGGCGAGC|AGTCTCCCAACCCCACTCTAGCCCAAGCCC
CCCACTCTAGCCCCGCTACGGCGAGCTTCT|TCCCAACCCCACTCTAGCCCAAGCCCGTCC
ACCCCACTCTAGCCCGAACCAGTATGGATT|TGCTCTTTGCCTACGAATGGACTGGGACGG
TAGCCCTAGCCCATAGTCTCCCAACCCCAC|TAGCCCCGCTACGGCGAGCTTCTTATAATA
CTCCCAACCCCACTCTAGCCCCGCTACGGC|TAATAGTCTCCCAACCCCACTCTAGCCCAA
CAACCCCACTCTATAATAGTCTCCCAACCC|CAGAATACCAATATAATAGTCTCCCAACCC
CCCAACCCCACTCTAGCCCTCTCGCGCCGT|TTCTTATAATAGTCTCCCAACCCCACTCTA
CCTATATAATAGTCTCCCAACCCCACTCTA|AGGCTTGCGACAAGGGAATGTAGCATAGTG
AACCCCACTCTAGCCCGTCATCTATAACAG|CCCACTCTAGCCCTAGCCCATAGTCTCCCA
ACTGTTAGAAGATATTCGCCGTTTACAGGG|TTGGGCCTTCCCCGACCACTGCTTAAGCTC
ACTCCTTCGTTAGCTATTGCGCAGAATTTG|CTTCTGCCTGAATGGCTCGGACCGCAGGCG
TCGGTGATATGCATGCGTGGCAGTAAGGCT|TGTTAGTGGTATAATAGTCTCCCAACCCCA
CCGAAGAGCCACGGCTACAGAATACCAATA|GTCTCCCAACCCCACTCTAGCCCACTTGTC
CATAGGCAACGACCTTCCAGGAGCGATAAA|GATCGCGAGTCGTTTGACTCCTTTCGGGAC
CATGCGTGGCAGTAAGGCTTGCGACAAGGG|TAATAGTCTCCCAACCCCACTCTAGCCCTT
ACGATCTTTTCAACTTTCTTGGTCCGGATC|CGAAATTTGTTATATATAATAGTCTCCCAA
ACTTTCTTGGTCCGGATCATAGGTGCCGGT|TATATAATAGTCTCCCAACCCCACTCTATA
CCCCACTCTAGCCCGTCATCTATAACAGCC|CACTCTAGCCCTAGCCCATAGTCTCCCAAC
CAAGGGAATGTAGCATAGTGTGTGGACTGG|GCCCTTGAATTCCATGTTAAGGCCCACAGC
GGTATAATAGTCTCCCAACCCCACTCTAGC|TATAATAGTCTCCCAACCCCACTCTAGCCC
AGGCCACCAAATATAATAGTCTCCCAACCC|AGAGGGATAAAGGCTCCTTAAGGTTCGGTG
TCTATAACAGCCCAATAGGGTGCTCTTTGC|TAGTCTCCCAACCCCACTCTAGCCCTCTCG
GACCAGTGGTCATCAGCGTCCAACTTCCCG|GGCCACCGGGAACTATAATGATGGGCACTG
AAGCCCGTCCTACGGACTGTTAGAAGATAT|GACTGGCAGGCTGACTTGGGCCTTCCCCGA
GTCGCCGAAGAGCCACGGCTACAGAATACC|AATAGTCTCCCAACCCCACTCTAGCCCACT
AGCTTCTTATAATAGTCTCCCAACCCCACT|CCCGTCCTACGGACTGTTAGAAGATATTCG
CTTCCCCGACCACTGCTTAAGCTCTAATAC|CGGCTGCTAGGCGGAGGATGTCGCTTTTAT
TACAGAATACCAATATAATAGTCTCCCAAC|TCTAGCCCACTTGTCTCCTATATAATAGTC
TCGACGATCTTTTCAACTTTCTTGGTCCGG|CTGCGAAATTTGTTATATATAATAGTCTCC
AGTAAACTCTCGGCCCTGCTACTAGATTTA|ACCCCACTCTAGCCCCGCCATCTGGTTAGC
ACTGGGATGGAAAGCGGGTGTTTCAGGTTA|GGAGGTATAATAGTCTCTATAATAGTCTCC
CATGTTAAGGCCCACAGCAGTCCATCTTGT|TAGGCAACGACCTTCCAGGAGCGATAAATT
AATAGTCTCCCAACCCCACTCTAGCCCGCG|CTGGGATGGAAAGCGGGTGTTTCAGGTTAT
GTCTCCTATATAATAGTCTCCCAACCCCAC|AGTAAGGCTTGCGACAAGGGAATGTAGCAT
TTCCTCAGCTCTATCAGTTGCTCACACGAA|ACGGGAGATAACATTATACATTCTACAGTA
GTGTATTTATATAATAGTCTCCCAACCCCA|CTCTAGCCCTGACTGGGATGGAAAGCGGGT
ACAAGGGAATGTAGCATAGTGTGTGGACTG|AGCCCTTGAATTCCATGTTAAGGCCCACAG
TCCCAACCCCACTCTATAATAGTCTCCCAA|CTACAGAATACCAATATAATAGTCTCCCAA
CCCACTTGAGAGGCCACCAAATATAATAGT|TTACAGGGTCAGAGGGATAAAGGCTCCTTA
TCATAGGTGCCGGTATAATAGTCTCCCAAC|AACCCCACTCTATAATAGTCTCCCAACCCC
CCCAACCCCACTCTAGCCCGTCATCTATAA|AACCCCACTCTAGCCCTAGCCCATAGTCTC
CCACTGCTTAAGCTCTAATACGTAGCAGTG|GGCGGAGGATGTCGCTTTTATTTCTCTTAG
ATTATTAAGGAGGTATAATAGTCTCTATAA|CGGAAGAGGCCTAGTGGGAACTCCTTCGTT
ACATTCTACAGTAAACTCTCGGCCCTGCTA|AGTCTCCCAACCCCACTCTAGCCCCGCCAT
TATTGCGCAGAATTTGACCAGTGGTCATCA|GCTCGGACCGCAGGCGGCCACCGGGAACTA
ATAATAGTCTCTATAATAGTCTCCCAACCC|TGGGAACTCCTTCGTTAGCTATTGCGCAGA
TTTGACTCCTTTCGGGACACGGGAGATAAC|CAACCCCACTCTAGCCCATGTTGACATGAT
AGTAAGGCTTGCGACAAGGGAATGTAGCAT|CCAACCCCACTCTAGCCCTTGAATTCCATG
TTAGAAGATATTCGCCGTTTACAGGGTCAG|GCCTTCCCCGACCACTGCTTAAGCTCTAAT
GTGTGAGGTGGCAAATTAGAGTCGCCGAAG|CTTGAGAGGCCACCAAATATAATAGTCTCC
AGAATACCAATATAATAGTCTCCCAACCCC|AGCCCACTTGTCTCCTATATAATAGTCTCC
GGCCTTCCCCGACCACTGCTTAAGCTCTAA|GTACGGCTGCTAGGCGGAGGATGTCGCTTT
ATAGTCTCCCAACCCCACTCTAGCCCCGCT|CTATATAATAGTCTCCCAACCCCACTCTAG
CATTATACATTCTACAGTAAACTCTCGGCC|TATAATAGTCTCCCAACCCCACTCTAGCCC
CTTAAGGTTCGGTGATATGCATGCGTGGCA|AGTGCTAATGTTAGTGGTATAATAGTCTCC
CTCGGTTGTGTATTTATATAATAGTCTCCC|AACCCCACTCTAGCCCTGACTGGGATGGAA
CGGCTACAGAATACCAATATAATAGTCTCC|CCACTCTAGCCCACTTGTCTCCTATATAAT
CGGTATAATAGTCTCCCAACCCCACTCTAG|TATAATAGTCTCCCAACCCCACTCTAGCCC
GGGATAAAGGCTCCTTAAGGTTCGGTGATA|CGTAGCAGTGGTCAGTGCTAATGTTAGTGG
CGGCGCTGCGAAATTTGTTATATATAATAG|GGTGGCAAATTAGAGTCGCCGAAGAGCCAC
CGGACTGTTAGAAGATATTCGCCGTTTACA|GACTTGGGCCTTCCCCGACCACTGCTTAAG
CACTCTAGCCCACTTGAGAGGCCACCAAAT|TTCGCCGTTTACAGGGTCAGAGGGATAAAG
GTGAGGTGGCAAATTAGAGTCGCCGAAGAG|TGAGAGGCCACCAAATATAATAGTCTCCCA
TTTATTTCTCTTAGGTCTCGGTTGTGTATT|GATATAATAGTCTCCCAACCCCACTCTAGC
GGTGTTTCAGGTTATTGCCAGATCGCGAGT|CTATAATAGTCTCCCAACCCCACTCTAGCC
CTATAATAGTCTCCCAACCCCACTCTAGCC|ATATAATAGTCTCCCAACCCCACTCTAGCC
AGTCGTTTGACTCCTTTCGGGACACGGGAG|GCCCCCAACCCCACTCTAGCCCATGTTGAC
CAACGACCTTCCAGGAGCGATAAATTCCTC|GAGTCGTTTGACTCCTTTCGGGACACGGGA
TTTGCCTACGAATGGACTGGGACGGCGCTG|TCTCGCGCCGTTTCAGGTGTGAGGTGGCAA
CGGCGAGCTTCTTATAATAGTCTCCCAACC|CCAAGCCCGTCCTACGGACTGTTAGAAGAT
GGCAGGCTGACTTGGGCCTTCCCCGACCAC|GCAGTCCATCTTGTGTACGGCTGCTAGGCG
GCCACCAAATATAATAGTCTCCCAACCCCA|AGGGATAAAGGCTCCTTAAGGTTCGGTGAT
CCCACTCTAGCCCCCAACCCCACTCTAGCC|GAATTTGACCAGTGGTCATCAGCGTCCAAC
ACCCCACTCTAGCCCACTTGTCTCCTATAT|GGTGATATGCATGCGTGGCAGTAAGGCTTG
GTCTCCCAACCCCACTCTATAATAGTCTCC|CGGCTACAGAATACCAATATAATAGTCTCC
ATTTGTTATATATAATAGTCTCCCAACCCC|GAGTCGCCGAAGAGCCACGGCTACAGAATA
CCCACTCTAGCCCATGTTGACATGATATAA|TCAGCGTCCAACTTCCCGGTAGATTAACAT
AATACCAATATAATAGTCTCCCAACCCCAC|CCCACTTGTCTCCTATATAATAGTCTCCCA
GAAGAGCCACGGCTACAGAATACCAATATA|CTCCCAACCCCACTCTAGCCCACTTGTCTC
AGCCCACTTGAGAGGCCACCAAATATAATA|GTTTACAGGGTCAGAGGGATAAAGGCTCCT
AGCCCTAGCCCATAGTCTCCCAACCCCACT|AGCCCCGCTACGGCGAGCTTCTTATAATAG
CCTTCGTTAGCTATTGCGCAGAATTTGACC|CTGCCTGAATGGCTCGGACCGCAGGCGGCC
TTCCATGTTAAGGCCCACAGCAGTCCATCT|TCATAGGCAACGACCTTCCAGGAGCGATAA
ATAATAGTCTCCCAACCCCACTCTAGCCCC|CGTTAGCTATTGCGCAGAATTTGACCAGTG
AGTCTCCCAACCCCACTCTAGCCCAAGCCC|CAAGGGAATGTAGCATAGTGTGTGGACTGG
TTAGCCGGAAGAGGCCTAGTGGGAACTCCT|TTCAGATTTTTACATAGACCATGCCTTCTG
GGAGGATGTCGCTTTTATTTCTCTTAGGTC|TTGCTCACACGAAGATATAATAGTCTCCCA
GTCTCCCAACCCCACTCTAGCCCCGCCATC|GCAATCAGATGGGATGCACTAATGATACCT
AATTTGACCAGTGGTCATCAGCGTCCAACT|CAGGCGGCCACCGGGAACTATAATGATGGG
CCCAACCCCACTCTAGCCCGAACCAGTATG|AGGGTGCTCTTTGCCTACGAATGGACTGGG
CCCAACCCCACTCTAGCCCAAGCCCGTCCT|GAATGTAGCATAGTGTGTGGACTGGCAGGC
GATAACATTATACATTCTACAGTAAACTCT|CATGATATAATAGTCTCCCAACCCCACTCT
ACCCCACTCTAGCCCATGTTGACATGATAT|CATCAGCGTCCAACTTCCCGGTAGATTAAC
AACCCCACTCTAGCCCGCGGGTCTCATAGG|AGCGGGTGTTTCAGGTTATTGCCAGATCGC
TATAATAGTCTCCCAACCCCACTCTAGCCC|TTGCGACAAGGGAATGTAGCATAGTGTGTG
GGTCAGAGGGATAAAGGCTCCTTAAGGTTC|TCTAATACGTAGCAGTGGTCAGTGCTAATG
CCATGTTAAGGCCCACAGCAGTCCATCTTG|ATAGGCAACGACCTTCCAGGAGCGATAAAT
GTGCTAATGTTAGTGGTATAATAGTCTCCC|CGGTTGTGTATTTATATAATAGTCTCCCAA
ATGTTAGTGGTATAATAGTCTCCCAACCCC|TGTATTTATATAATAGTCTCCCAACCCCAC
ACTCTAGCCCATGTTGACATGATATAATAG|GCGTCCAACTTCCCGGTAGATTAACATTGG
AGGCTCCTTAAGGTTCGGTGATATGCATGC|GTGGTCAGTGCTAATGTTAGTGGTATAATA
CGACCACTGCTTAAGCTCTAATACGTAGCA|CTAGGCGGAGGATGTCGCTTTTATTTCTCT
AGAGGCCTAGTGGGAACTCCTTCGTTAGCT|TTACATAGACCATGCCTTCTGCCTGAATGG
TGATATGCATGCGTGGCAGTAAGGCTTGCG|AGTGGTATAATAGTCTCCCAACCCCACTCT
CCCAACCCCACTCTAGCCCTTGAATTCCAT|CAACCCCACTCTAGCCCGCGGGTCTCATAG
CATAGGTGCCGGTATAATAGTCTCCCAACC|ACCCCACTCTATAATAGTCTCCCAACCCCA
ACCCCACTCTAGCCCTGACTGGGATGGAAA|CTAGATTTAATTATTAAGGAGGTATAATAG
CCGTCCTACGGACTGTTAGAAGATATTCGC|GGCAGGCTGACTTGGGCCTTCCCCGACCAC
TCTCCCAACCCCACTCTAGCCCAAGCCCGT|AGGGAATGTAGCATAGTGTGTGGACTGGCA
CTATAATAGTCTCCCAACCCCACTCTAGCC|TTCGTTAGCTATTGCGCAGAATTTGACCAG
TCGTTAGCTATTGCGCAGAATTTGACCAGT|CCTGAATGGCTCGGACCGCAGGCGGCCACC
CTCTAGCCCTGACTGGGATGGAAAGCGGGT|TTAATTATTAAGGAGGTATAATAGTCTCTA
GCTATTGCGCAGAATTTGACCAGTGGTCAT|TGGCTCGGACCGCAGGCGGCCACCGGGAAC
AACCCCACTCTAGCCCCGCCATCTGGTTAG|GATGGGATGCACTAATGATACCTTCCTTCA
CTCACACGAAGATATAATAGTCTCCCAACC|TTCTACAGTAAACTCTCGGCCCTGCTACTA
CAAATATAATAGTCTCCCAACCCCACTCTA|TAAAGGCTCCTTAAGGTTCGGTGATATGCA
CAGCAGTCCATCTTGTGTACGGCTGCTAGG|CCAGGAGCGATAAATTCCTCAGCTCTATCA
CTAGCCCACTTGAGAGGCCACCAAATATAA|CCGTTTACAGGGTCAGAGGGATAAAGGCTC
TCTTATAATAGTCTCCCAACCCCACTCTAG|TCCTACGGACTGTTAGAAGATATTCGCCGT
CCAACCCCACTCTAGCCCTGACTGGGATGG|CTACTAGATTTAATTATTAAGGAGGTATAA
AGTGCTAATGTTAGTGGTATAATAGTCTCC|TCGGTTGTGTATTTATATAATAGTCTCCCA
GCGATAAATTCCTCAGCTCTATCAGTTGCT|TTCGGGACACGGGAGATAACATTATACATT
TTTAATTATTAAGGAGGTATAATAGTCTCT|TAGCCGGAAGAGGCCTAGTGGGAACTCCTT
TAGTCTCCCAACCCCACTCTAGCCCTGACT|GGCCCTGCTACTAGATTTAATTATTAAGGA
CCCCACTCTAGCCCACTTGTCTCCTATATA|GTGATATGCATGCGTGGCAGTAAGGCTTGC
TACAGTAAACTCTCGGCCCTGCTACTAGAT|CCAACCCCACTCTAGCCCCGCCATCTGGTT
ACTGGCAGGCTGACTTGGGCCTTCCCCGAC|ACAGCAGTCCATCTTGTGTACGGCTGCTAG
CCCACTCTAGCCCAAGCCCGTCCTACGGAC|AGCATAGTGTGTGGACTGGCAGGCTGACTT
TTTCAGGTTATTGCCAGATCGCGAGTCGTT|AATAGTCTCCCAACCCCACTCTAGCCCCCA
GAAGAGGCCTAGTGGGAACTCCTTCGTTAG|TTTTACATAGACCATGCCTTCTGCCTGAAT
CCCACTCTAGCCCTGACTGGGATGGAAAGC|AGATTTAATTATTAAGGAGGTATAATAGTC
TCCCAACCCCACTCTAGCCCACTTGTCTCC|GGTTCGGTGATATGCATGCGTGGCAGTAAG
CGGGTCTCATAGGCAACGACCTTCCAGGAG|ATTGCCAGATCGCGAGTCGTTTGACTCCTT
TAATAGTCTCCCAACCCCACTCTAGCCCTA|TAATAGTCTCCCAACCCCACTCTAGCCCCG
GCTCCTTAAGGTTCGGTGATATGCATGCGT|GGTCAGTGCTAATGTTAGTGGTATAATAGT
AGGATGTCGCTTTTATTTCTCTTAGGTCTC|GCTCACACGAAGATATAATAGTCTCCCAAC
GCGCTGCGAAATTTGTTATATATAATAGTC|TGGCAAATTAGAGTCGCCGAAGAGCCACGG
CCCAATAGGGTGCTCTTTGCCTACGAATGG|ACCCCACTCTAGCCCTCTCGCGCCGTTTCA
CGAACCAGTATGGATTCATCGACGATCTTT|GAATGGACTGGGACGGCGCTGCGAAATTTG
AATTATTAAGGAGGTATAATAGTCTCTATA|CCGGAAGAGGCCTAGTGGGAACTCCTTCGT
ATACGTAGCAGTGGTCAGTGCTAATGTTAG|TTATTTCTCTTAGGTCTCGGTTGTGTATTT
GCCGGTATAATAGTCTCCCAACCCCACTCT|TCTATAATAGTCTCCCAACCCCACTCTAGC
CACTCTAGCCCCCAACCCCACTCTAGCCCA|ATTTGACCAGTGGTCATCAGCGTCCAACTT
TCTCCCAACCCCACTCTAGCCCACTTGTCT|AAGGTTCGGTGATATGCATGCGTGGCAGTA
CAGTAAGGCTTGCGACAAGGGAATGTAGCA|CCCAACCCCACTCTAGCCCTTGAATTCCAT
CCTGACTGGGATGGAAAGCGGGTGTTTCAG|TTAAGGAGGTATAATAGTCTCTATAATAGT
GCCCTGCTACTAGATTTAATTATTAAGGAG|CCCCGCCATCTGGTTAGCCGGAAGAGGCCT
TAGTCTCCCAACCCCACTCTAGCCCCGCCA|TGGCAATCAGATGGGATGCACTAATGATAC
CAGTCCATCTTGTGTACGGCTGCTAGGCGG|GGAGCGATAAATTCCTCAGCTCTATCAGTT
CTTGGTCCGGATCATAGGTGCCGGTATAAT|AATAGTCTCCCAACCCCACTCTATAATAGT
ACAGTAAACTCTCGGCCCTGCTACTAGATT|CAACCCCACTCTAGCCCCGCCATCTGGTTA
TACGGCTGCTAGGCGGAGGATGTCGCTTTT|CTCAGCTCTATCAGTTGCTCACACGAAGAT
AACCCCACTCTAGCCCTCTCGCGCCGTTTC|TTATAATAGTCTCCCAACCCCACTCTAGCC
CACACGAAGATATAATAGTCTCCCAACCCC|CTACAGTAAACTCTCGGCCCTGCTACTAGA
TAGTGTGTGGACTGGCAGGCTGACTTGGGC|GTTAAGGCCCACAGCAGTCCATCTTGTGTA
CTGCTACTAGATTTAATTATTAAGGAGGTA|CGCCATCTGGTTAGCCGGAAGAGGCCTAGT
ATAATAGTCTCCCAACCCCACTCTAGCCCG|ACAGCCCAATAGGGTGCTCTTTGCCTACGA
CCACTCTAGCCCGCGGGTCTCATAGGCAAC|GGTGTTTCAGGTTATTGCCAGATCGCGAGT
ACGAATGGACTGGGACGGCGCTGCGAAATT|CCGTTTCAGGTGTGAGGTGGCAAATTAGAG
TGGACTGGCAGGCTGACTTGGGCCTTCCCC|CCCACAGCAGTCCATCTTGTGTACGGCTGC
CCATCTTGTGTACGGCTGCTAGGCGGAGGA|CGATAAATTCCTCAGCTCTATCAGTTGCTC
AGTCTCCCAACCCCACTCTAGCCCACTTGA|CTGTTAGAAGATATTCGCCGTTTACAGGGT
CTTAGGTCTCGGTTGTGTATTTATATAATA|GTCTCCCAACCCCACTCTAGCCCTGACTGG
GCCCACAGCAGTCCATCTTGTGTACGGCTG|ACCTTCCAGGAGCGATAAATTCCTCAGCTC
CACTCTAGCCCTAGCCCATAGTCTCCCAAC|CACTCTAGCCCCGCTACGGCGAGCTTCTTA
GATTTAATTATTAAGGAGGTATAATAGTCT|GTTAGCCGGAAGAGGCCTAGTGGGAACTCC
TGTTGACATGATATAATAGTCTCCCAACCC|CCCGGTAGATTAACATTGGCAATCAGATGG
CGGCCCTGCTACTAGATTTAATTATTAAGG|AGCCCCGCCATCTGGTTAGCCGGAAGAGGC
CCCTCTCGCGCCGTTTCAGGTGTGAGGTGG|CCAACCCCACTCTAGCCCACTTGAGAGGCC
TAGCCCCGCTACGGCGAGCTTCTTATAATA|CCCACTCTAGCCCAAGCCCGTCCTACGGAC
CGCTGCGAAATTTGTTATATATAATAGTCT|GGCAAATTAGAGTCGCCGAAGAGCCACGGC
AGTCTCCCAACCCCACTCTAGCCCCGCTAC|ATATAATAGTCTCCCAACCCCACTCTAGCC
CTTGTGTACGGCTGCTAGGCGGAGGATGTC|AAATTCCTCAGCTCTATCAGTTGCTCACAC
CTGCGAAATTTGTTATATATAATAGTCTCC|CAAATTAGAGTCGCCGAAGAGCCACGGCTA
TTGCCAGATCGCGAGTCGTTTGACTCCTTT|CAACCCCACTCTAGCCCCCAACCCCACTCT
CGTCATCTATAACAGCCCAATAGGGTGCTC|GCCCATAGTCTCCCAACCCCACTCTAGCCC
CCCCACTCTAGCCCACTTGAGAGGCCACCA|ATATTCGCCGTTTACAGGGTCAGAGGGATA
TCCCAACCCCACTCTAGCCCACTTGAGAGG|TAGAAGATATTCGCCGTTTACAGGGTCAGA
TGTTAAGGCCCACAGCAGTCCATCTTGTGT|GGCAACGACCTTCCAGGAGCGATAAATTCC
AGCTCTATCAGTTGCTCACACGAAGATATA|GATAACATTATACATTCTACAGTAAACTCT
CTTGTCTCCTATATAATAGTCTCCCAACCC|GGCAGTAAGGCTTGCGACAAGGGAATGTAG
AAAGCGGGTGTTTCAGGTTATTGCCAGATC|TAGTCTCTATAATAGTCTCCCAACCCCACT
AATTCCTCAGCTCTATCAGTTGCTCACACG|ACACGGGAGATAACATTATACATTCTACAG
AATGTAGCATAGTGTGTGGACTGGCAGGCT|GAATTCCATGTTAAGGCCCACAGCAGTCCA
GAGGCCTAGTGGGAACTCCTTCGTTAGCTA|TACATAGACCATGCCTTCTGCCTGAATGGC
GCCCATGTTGACATGATATAATAGTCTCCC|AACTTCCCGGTAGATTAACATTGGCAATCA
AAGCGGGTGTTTCAGGTTATTGCCAGATCG|AGTCTCTATAATAGTCTCCCAACCCCACTC
GAGCTTCTTATAATAGTCTCCCAACCCCAC|GCCCGTCCTACGGACTGTTAGAAGATATTC
TAGATTTAATTATTAAGGAGGTATAATAGT|TGGTTAGCCGGAAGAGGCCTAGTGGGAACT
CCACTCTAGCCCTTGAATTCCATGTTAAGG|ACTCTAGCCCGCGGGTCTCATAGGCAACGA
TGTTAGTGGTATAATAGTCTCCCAACCCCA|GTATTTATATAATAGTCTCCCAACCCCACT
AGTCTCCCAACCCCACTCTAGCCCCCAACC|GCTATTGCGCAGAATTTGACCAGTGGTCAT
GCGAGCTTCTTATAATAGTCTCCCAACCCC|AAGCCCGTCCTACGGACTGTTAGAAGATAT
CGAGTCGTTTGACTCCTTTCGGGACACGGG|TAGCCCCCAACCCCACTCTAGCCCATGTTG
TGGGCCTTCCCCGACCACTGCTTAAGCTCT|GTGTACGGCTGCTAGGCGGAGGATGTCGCT
TTGACCAGTGGTCATCAGCGTCCAACTTCC|GCGGCCACCGGGAACTATAATGATGGGCAC
TAGTCTCCCAACCCCACTCTAGCCCTTGAA|GTCTCCCAACCCCACTCTAGCCCGCGGGTC
AAGCTCTAATACGTAGCAGTGGTCAGTGCT|TGTCGCTTTTATTTCTCTTAGGTCTCGGTT
TAGGTGCCGGTATAATAGTCTCCCAACCCC|CCCACTCTATAATAGTCTCCCAACCCCACT
ACTGCTTAAGCTCTAATACGTAGCAGTGGT|CGGAGGATGTCGCTTTTATTTCTCTTAGGT
AGCGATAAATTCCTCAGCTCTATCAGTTGC|TTTCGGGACACGGGAGATAACATTATACAT
GGATTCATCGACGATCTTTTCAACTTTCTT|GACGGCGCTGCGAAATTTGTTATATATAAT
ATTGCGCAGAATTTGACCAGTGGTCATCAG|CTCGGACCGCAGGCGGCCACCGGGAACTAT
TTTCGGGACACGGGAGATAACATTATACAT|TCTAGCCCATGTTGACATGATATAATAGTC
CTCCCAACCCCACTCTAGCCCCGCCATCTG|AATCAGATGGGATGCACTAATGATACCTTC
TCTCGCGCCGTTTCAGGTGTGAGGTGGCAA|ACCCCACTCTAGCCCACTTGAGAGGCCACC
AGTCTCCCAACCCCACTCTAGCCCACTTGT|TTAAGGTTCGGTGATATGCATGCGTGGCAG
AACAGCCCAATAGGGTGCTCTTTGCCTACG|TCCCAACCCCACTCTAGCCCTCTCGCGCCG
CTCTAATACGTAGCAGTGGTCAGTGCTAAT|CGCTTTTATTTCTCTTAGGTCTCGGTTGTG
CTCTAGCCCAAGCCCGTCCTACGGACTGTT|TAGTGTGTGGACTGGCAGGCTGACTTGGGC
ATTATACATTCTACAGTAAACTCTCGGCCC|ATAATAGTCTCCCAACCCCACTCTAGCCCC
CATGATATAATAGTCTCCCAACCCCACTCT|AGATTAACATTGGCAATCAGATGGGATGCA
ATAATAGTCTCCCAACCCCACTCTAGCCCA|GCTCCTTAAGGTTCGGTGATATGCATGCGT
AGCTCTAATACGTAGCAGTGGTCAGTGCTA|GTCGCTTTTATTTCTCTTAGGTCTCGGTTG
GTGTACGGCTGCTAGGCGGAGGATGTCGCT|TTCCTCAGCTCTATCAGTTGCTCACACGAA
CCCCACTCTAGCCCTGACTGGGATGGAAAG|TAGATTTAATTATTAAGGAGGTATAATAGT
CATCTTGTGTACGGCTGCTAGGCGGAGGAT|GATAAATTCCTCAGCTCTATCAGTTGCTCA
TCATAGGCAACGACCTTCCAGGAGCGATAA|AGATCGCGAGTCGTTTGACTCCTTTCGGGA
TCCCCGACCACTGCTTAAGCTCTAATACGT|GCTGCTAGGCGGAGGATGTCGCTTTTATTT
GTCTCCCAACCCCACTCTAGCCCTGACTGG|CCCTGCTACTAGATTTAATTATTAAGGAGG
AGTCTCCCAACCCCACTCTAGCCCTCTCGC|CGAGCTTCTTATAATAGTCTCCCAACCCCA
TTATTTCTCTTAGGTCTCGGTTGTGTATTT|ATATAATAGTCTCCCAACCCCACTCTAGCC
TTGAATTCCATGTTAAGGCCCACAGCAGTC|GGGTCTCATAGGCAACGACCTTCCAGGAGC
GTCCTACGGACTGTTAGAAGATATTCGCCG|CAGGCTGACTTGGGCCTTCCCCGACCACTG
AGCCCACTTGTCTCCTATATAATAGTCTCC|ATGCGTGGCAGTAAGGCTTGCGACAAGGGA
AGCCCAAGCCCGTCCTACGGACTGTTAGAA|GTGTGGACTGGCAGGCTGACTTGGGCCTTC
GAGGCCACCAAATATAATAGTCTCCCAACC|CAGAGGGATAAAGGCTCCTTAAGGTTCGGT
CATCTATAACAGCCCAATAGGGTGCTCTTT|CATAGTCTCCCAACCCCACTCTAGCCCTCT
CTTTTATTTCTCTTAGGTCTCGGTTGTGTA|AAGATATAATAGTCTCCCAACCCCACTCTA
GTGGACTGGCAGGCTGACTTGGGCCTTCCC|GCCCACAGCAGTCCATCTTGTGTACGGCTG
AACCCCACTCTAGCCCCCAACCCCACTCTA|GCAGAATTTGACCAGTGGTCATCAGCGTCC
CACTCTAGCCCTGACTGGGATGGAAAGCGG|ATTTAATTATTAAGGAGGTATAATAGTCTC
ACTCTAGCCCGTCATCTATAACAGCCCAAT|CTAGCCCTAGCCCATAGTCTCCCAACCCCA
CGCCGTTTCAGGTGTGAGGTGGCAAATTAG|ACTCTAGCCCACTTGAGAGGCCACCAAATA
TATATAATAGTCTCCCAACCCCACTCTAGC|CCTGACTGGGATGGAAAGCGGGTGTTTCAG
TATTTCTCTTAGGTCTCGGTTGTGTATTTA|TATAATAGTCTCCCAACCCCACTCTAGCCC
CCCACTCTAGCCCGCGGGTCTCATAGGCAA|GGGTGTTTCAGGTTATTGCCAGATCGCGAG
ATGTCGCTTTTATTTCTCTTAGGTCTCGGT|CACACGAAGATATAATAGTCTCCCAACCCC
GGATCATAGGTGCCGGTATAATAGTCTCCC|CCCAACCCCACTCTATAATAGTCTCCCAAC
CGCCGTTTACAGGGTCAGAGGGATAAAGGC|CACTGCTTAAGCTCTAATACGTAGCAGTGG
TAGCCCTGACTGGGATGGAAAGCGGGTGTT|ATTATTAAGGAGGTATAATAGTCTCTATAA
CCTTCCAGGAGCGATAAATTCCTCAGCTCT|TTTGACTCCTTTCGGGACACGGGAGATAAC
TCCCAACCCCACTCTAGCCCGAACCAGTAT|TAGGGTGCTCTTTGCCTACGAATGGACTGG
CGTCCTACGGACTGTTAGAAGATATTCGCC|GCAGGCTGACTTGGGCCTTCCCCGACCACT
CAACCCCACTCTAGCCCACTTGAGAGGCCA|AAGATATTCGCCGTTTACAGGGTCAGAGGG
AATAGTCTCCCAACCCCACTCTAGCCCGTC|AGTCTCCCAACCCCACTCTAGCCCTAGCCC
ACACGGGAGATAACATTATACATTCTACAG|CATGTTGACATGATATAATAGTCTCCCAAC
TATATATAATAGTCTCCCAACCCCACTCTA|CCGAAGAGCCACGGCTACAGAATACCAATA
TCCTTTCGGGACACGGGAGATAACATTATA|CACTCTAGCCCATGTTGACATGATATAATA
GGACTGGCAGGCTGACTTGGGCCTTCCCCG|CCACAGCAGTCCATCTTGTGTACGGCTGCT
ATATGCATGCGTGGCAGTAAGGCTTGCGAC|TGGTATAATAGTCTCCCAACCCCACTCTAG
TCTAGCCCGCGGGTCTCATAGGCAACGACC|TTTCAGGTTATTGCCAGATCGCGAGTCGTT
ACCCCACTCTAGCCCACTTGAGAGGCCACC|GATATTCGCCGTTTACAGGGTCAGAGGGAT
AACCCCACTCTAGCCCAAGCCCGTCCTACG|TGTAGCATAGTGTGTGGACTGGCAGGCTGA
AGCCCCGCCATCTGGTTAGCCGGAAGAGGC|CTAATGATACCTTCCTTCAGATTTTTACAT
GACGATCTTTTCAACTTTCTTGGTCCGGAT|GCGAAATTTGTTATATATAATAGTCTCCCA
GGACTGTTAGAAGATATTCGCCGTTTACAG|ACTTGGGCCTTCCCCGACCACTGCTTAAGC
TCTTGTGTACGGCTGCTAGGCGGAGGATGT|TAAATTCCTCAGCTCTATCAGTTGCTCACA
ATCATAGGTGCCGGTATAATAGTCTCCCAA|CAACCCCACTCTATAATAGTCTCCCAACCC
TAATAGTCTCCCAACCCCACTCTAGCCCGA|CAGCCCAATAGGGTGCTCTTTGCCTACGAA
AACCCCACTCTAGCCCACTTGTCTCCTATA|CGGTGATATGCATGCGTGGCAGTAAGGCTT
CAGGGTCAGAGGGATAAAGGCTCCTTAAGG|AGCTCTAATACGTAGCAGTGGTCAGTGCTA
GACCACTGCTTAAGCTCTAATACGTAGCAG|TAGGCGGAGGATGTCGCTTTTATTTCTCTT
CCAGATCGCGAGTCGTTTGACTCCTTTCGG|CCCCACTCTAGCCCCCAACCCCACTCTAGC
AGAGCCACGGCTACAGAATACCAATATAAT|CCCAACCCCACTCTAGCCCACTTGTCTCCT
TGGCAAATTAGAGTCGCCGAAGAGCCACGG|GCCACCAAATATAATAGTCTCCCAACCCCA
CTCTAGCCCATGTTGACATGATATAATAGT|CGTCCAACTTCCCGGTAGATTAACATTGGC
CTCCCAACCCCACTCTAGCCCGTCATCTAT|CCAACCCCACTCTAGCCCTAGCCCATAGTC
AAGGGAATGTAGCATAGTGTGTGGACTGGC|CCCTTGAATTCCATGTTAAGGCCCACAGCA
AGCCCTGACTGGGATGGAAAGCGGGTGTTT|TTATTAAGGAGGTATAATAGTCTCTATAAT
CCACTCTAGCCCACTTGTCTCCTATATAAT|GATATGCATGCGTGGCAGTAAGGCTTGCGA
CTACGAATGGACTGGGACGGCGCTGCGAAA|CGCCGTTTCAGGTGTGAGGTGGCAAATTAG
CCAATATAATAGTCTCCCAACCCCACTCTA|CTTGTCTCCTATATAATAGTCTCCCAACCC
TGATATAATAGTCTCCCAACCCCACTCTAG|ATTAACATTGGCAATCAGATGGGATGCACT
TTAAGGTTCGGTGATATGCATGCGTGGCAG|GTGCTAATGTTAGTGGTATAATAGTCTCCC
TTTTATTTCTCTTAGGTCTCGGTTGTGTAT|AGATATAATAGTCTCCCAACCCCACTCTAG
AACTCCTTCGTTAGCTATTGCGCAGAATTT|CCTTCTGCCTGAATGGCTCGGACCGCAGGC
TCGCGCCGTTTCAGGTGTGAGGTGGCAAAT|CCCACTCTAGCCCACTTGAGAGGCCACCAA
CATAGTGTGTGGACTGGCAGGCTGACTTGG|ATGTTAAGGCCCACAGCAGTCCATCTTGTG
CGCGCCGTTTCAGGTGTGAGGTGGCAAATT|CCACTCTAGCCCACTTGAGAGGCCACCAAA
CACTTGTCTCCTATATAATAGTCTCCCAAC|GTGGCAGTAAGGCTTGCGACAAGGGAATGT
CCCCCAACCCCACTCTAGCCCATGTTGACA|AGTGGTCATCAGCGTCCAACTTCCCGGTAG
CCCGCTACGGCGAGCTTCTTATAATAGTCT|CTCTAGCCCAAGCCCGTCCTACGGACTGTT
TCTCCCAACCCCACTCTAGCCCCGCTACGG|ATAATAGTCTCCCAACCCCACTCTAGCCCA
CCTACGGACTGTTAGAAGATATTCGCCGTT|GGCTGACTTGGGCCTTCCCCGACCACTGCT
TGAATTCCATGTTAAGGCCCACAGCAGTCC|GGTCTCATAGGCAACGACCTTCCAGGAGCG
TTGTGTACGGCTGCTAGGCGGAGGATGTCG|AATTCCTCAGCTCTATCAGTTGCTCACACG
GCCCGTCATCTATAACAGCCCAATAGGGTG|CTAGCCCATAGTCTCCCAACCCCACTCTAG
ATATAATAGTCTCCCAACCCCACTCTATAA|AAGAGCCACGGCTACAGAATACCAATATAA
CGAAATTTGTTATATATAATAGTCTCCCAA|ATTAGAGTCGCCGAAGAGCCACGGCTACAG
ATAGTCTCTATAATAGTCTCCCAACCCCAC|GAACTCCTTCGTTAGCTATTGCGCAGAATT
CTAGCCCATGTTGACATGATATAATAGTCT|TCCAACTTCCCGGTAGATTAACATTGGCAA
CCATAGTCTCCCAACCCCACTCTAGCCCTC|ACGGCGAGCTTCTTATAATAGTCTCCCAAC
CTTGCGACAAGGGAATGTAGCATAGTGTGT|CACTCTAGCCCTTGAATTCCATGTTAAGGC
TTAGGTCTCGGTTGTGTATTTATATAATAG|TCTCCCAACCCCACTCTAGCCCTGACTGGG
GAGTCGCCGAAGAGCCACGGCTACAGAATA|ATAATAGTCTCCCAACCCCACTCTAGCCCA
TTGCGACAAGGGAATGTAGCATAGTGTGTG|ACTCTAGCCCTTGAATTCCATGTTAAGGCC
CCACGGCTACAGAATACCAATATAATAGTC|ACCCCACTCTAGCCCACTTGTCTCCTATAT
TTTACAGGGTCAGAGGGATAAAGGCTCCTT|CTTAAGCTCTAATACGTAGCAGTGGTCAGT
GATATGCATGCGTGGCAGTAAGGCTTGCGA|GTGGTATAATAGTCTCCCAACCCCACTCTA
AGTTGCTCACACGAAGATATAATAGTCTCC|ATACATTCTACAGTAAACTCTCGGCCCTGC
ACTCCTTTCGGGACACGGGAGATAACATTA|CCCACTCTAGCCCATGTTGACATGATATAA
GTAAACTCTCGGCCCTGCTACTAGATTTAA|CCCCACTCTAGCCCCGCCATCTGGTTAGCC
GGCTGACTTGGGCCTTCCCCGACCACTGCT|TCCATCTTGTGTACGGCTGCTAGGCGGAGG
CCACTCTAGCCCCGCCATCTGGTTAGCCGG|GGATGCACTAATGATACCTTCCTTCAGATT
TTGTTATATATAATAGTCTCCCAACCCCAC|GTCGCCGAAGAGCCACGGCTACAGAATACC
GCTACGGCGAGCTTCTTATAATAGTCTCCC|TAGCCCAAGCCCGTCCTACGGACTGTTAGA
CACTCTAGCCCGTCATCTATAACAGCCCAA|TCTAGCCCTAGCCCATAGTCTCCCAACCCC
GAATTCCATGTTAAGGCCCACAGCAGTCCA|GTCTCATAGGCAACGACCTTCCAGGAGCGA
ACTCTAGCCCCGCCATCTGGTTAGCCGGAA|ATGCACTAATGATACCTTCCTTCAGATTTT
AACCCCACTCTAGCCCCGCTACGGCGAGCT|GTCTCCCAACCCCACTCTAGCCCAAGCCCG
TCTCCCAACCCCACTCTATAATAGTCTCCC|GGCTACAGAATACCAATATAATAGTCTCCC
AATGGACTGGGACGGCGCTGCGAAATTTGT|TTTCAGGTGTGAGGTGGCAAATTAGAGTCG
GGCAAATTAGAGTCGCCGAAGAGCCACGGC|CCACCAAATATAATAGTCTCCCAACCCCAC
GGTGTGAGGTGGCAAATTAGAGTCGCCGAA|ACTTGAGAGGCCACCAAATATAATAGTCTC
ATGGAAAGCGGGTGTTTCAGGTTATTGCCA|ATAATAGTCTCTATAATAGTCTCCCAACCC
TGCCGGTATAATAGTCTCCCAACCCCACTC|CTCTATAATAGTCTCCCAACCCCACTCTAG
ATAGTCTCCCAACCCCACTCTAGCCCCGCC|TTGGCAATCAGATGGGATGCACTAATGATA
TCGTTTGACTCCTTTCGGGACACGGGAGAT|CCCCAACCCCACTCTAGCCCATGTTGACAT
GTTAGAAGATATTCGCCGTTTACAGGGTCA|GGCCTTCCCCGACCACTGCTTAAGCTCTAA
CTCGGCCCTGCTACTAGATTTAATTATTAA|CTAGCCCCGCCATCTGGTTAGCCGGAAGAG
TGTGTACGGCTGCTAGGCGGAGGATGTCGC|ATTCCTCAGCTCTATCAGTTGCTCACACGA
GACGGCGCTGCGAAATTTGTTATATATAAT|GAGGTGGCAAATTAGAGTCGCCGAAGAGCC
TCCCAACCCCACTCTAGCCCCGCCATCTGG|ATCAGATGGGATGCACTAATGATACCTTCC
TAATGTTAGTGGTATAATAGTCTCCCAACC|TGTGTATTTATATAATAGTCTCCCAACCCC
AGGTGTGAGGTGGCAAATTAGAGTCGCCGA|CACTTGAGAGGCCACCAAATATAATAGTCT
GCTCTATCAGTTGCTCACACGAAGATATAA|ATAACATTATACATTCTACAGTAAACTCTC
CTAGCCCACTTGTCTCCTATATAATAGTCT|GCATGCGTGGCAGTAAGGCTTGCGACAAGG
TGCCAGATCGCGAGTCGTTTGACTCCTTTC|AACCCCACTCTAGCCCCCAACCCCACTCTA
ATAGTCTCCCAACCCCACTCTAGCCCACTT|CCTTAAGGTTCGGTGATATGCATGCGTGGC
ACATGATATAATAGTCTCCCAACCCCACTC|TAGATTAACATTGGCAATCAGATGGGATGC
GTATTTATATAATAGTCTCCCAACCCCACT|CTAGCCCTGACTGGGATGGAAAGCGGGTGT
GCGGAGGATGTCGCTTTTATTTCTCTTAGG|AGTTGCTCACACGAAGATATAATAGTCTCC
CACAGCAGTCCATCTTGTGTACGGCTGCTA|TTCCAGGAGCGATAAATTCCTCAGCTCTAT
GTAGCATAGTGTGTGGACTGGCAGGCTGAC|TTCCATGTTAAGGCCCACAGCAGTCCATCT
TTAGTGGTATAATAGTCTCCCAACCCCACT|ATTTATATAATAGTCTCCCAACCCCACTCT
CACTCTAGCCCATGTTGACATGATATAATA|AGCGTCCAACTTCCCGGTAGATTAACATTG
CTAGCCCGAACCAGTATGGATTCATCGACG|GCCTACGAATGGACTGGGACGGCGCTGCGA
CCCATGTTGACATGATATAATAGTCTCCCA|ACTTCCCGGTAGATTAACATTGGCAATCAG
TAGGTCTCGGTTGTGTATTTATATAATAGT|CTCCCAACCCCACTCTAGCCCTGACTGGGA
TTATTGCCAGATCGCGAGTCGTTTGACTCC|TCCCAACCCCACTCTAGCCCCCAACCCCAC
TTTGTTATATATAATAGTCTCCCAACCCCA|AGTCGCCGAAGAGCCACGGCTACAGAATAC
TTCTTGGTCCGGATCATAGGTGCCGGTATA|ATAATAGTCTCCCAACCCCACTCTATAATA
TCTCCCAACCCCACTCTAGCCCTGACTGGG|CCTGCTACTAGATTTAATTATTAAGGAGGT
GCCTTCCCCGACCACTGCTTAAGCTCTAAT|TACGGCTGCTAGGCGGAGGATGTCGCTTTT
CAACCCCACTCTAGCCCACTTGTCTCCTAT|TCGGTGATATGCATGCGTGGCAGTAAGGCT
CTCGCGCCGTTTCAGGTGTGAGGTGGCAAA|CCCCACTCTAGCCCACTTGAGAGGCCACCA
TTAAGGCCCACAGCAGTCCATCTTGTGTAC|CAACGACCTTCCAGGAGCGATAAATTCCTC
TAAAGGCTCCTTAAGGTTCGGTGATATGCA|GCAGTGGTCAGTGCTAATGTTAGTGGTATA
TCTAGCCCTGACTGGGATGGAAAGCGGGTG|TAATTATTAAGGAGGTATAATAGTCTCTAT
TGCATGCGTGGCAGTAAGGCTTGCGACAAG|TATAATAGTCTCCCAACCCCACTCTAGCCC
GCCCAATAGGGTGCTCTTTGCCTACGAATG|AACCCCACTCTAGCCCTCTCGCGCCGTTTC
ACCAAATATAATAGTCTCCCAACCCCACTC|GATAAAGGCTCCTTAAGGTTCGGTGATATG
TAGGGTGCTCTTTGCCTACGAATGGACTGG|ACTCTAGCCCTCTCGCGCCGTTTCAGGTGT
ATAACATTATACATTCTACAGTAAACTCTC|ATGATATAATAGTCTCCCAACCCCACTCTA
AGCCCGTCCTACGGACTGTTAGAAGATATT|ACTGGCAGGCTGACTTGGGCCTTCCCCGAC
TCTTGGTCCGGATCATAGGTGCCGGTATAA|TAATAGTCTCCCAACCCCACTCTATAATAG
GGAATGTAGCATAGTGTGTGGACTGGCAGG|TTGAATTCCATGTTAAGGCCCACAGCAGTC
GCAGTAAGGCTTGCGACAAGGGAATGTAGC|TCCCAACCCCACTCTAGCCCTTGAATTCCA
CAGCTCTATCAGTTGCTCACACGAAGATAT|AGATAACATTATACATTCTACAGTAAACTC
CCCAACCCCACTCTAGCCCTGACTGGGATG|GCTACTAGATTTAATTATTAAGGAGGTATA
TATCAGTTGCTCACACGAAGATATAATAGT|CATTATACATTCTACAGTAAACTCTCGGCC
CCACTCTAGCCCACTTGAGAGGCCACCAAA|ATTCGCCGTTTACAGGGTCAGAGGGATAAA
GTCTCCCAACCCCACTCTAGCCCAAGCCCG|AAGGGAATGTAGCATAGTGTGTGGACTGGC
CCAACCCCACTCTAGCCCATGTTGACATGA|GGTCATCAGCGTCCAACTTCCCGGTAGATT
TTCGGTGATATGCATGCGTGGCAGTAAGGC|ATGTTAGTGGTATAATAGTCTCCCAACCCC
ATCTTGTGTACGGCTGCTAGGCGGAGGATG|ATAAATTCCTCAGCTCTATCAGTTGCTCAC
TCTCCCAACCCCACTCTAGCCCGCGGGTCT|ATGGAAAGCGGGTGTTTCAGGTTATTGCCA
ATAATAGTCTCCCAACCCCACTCTAGCCCC|ACATTGGCAATCAGATGGGATGCACTAATG
GAATTTGACCAGTGGTCATCAGCGTCCAAC|GCAGGCGGCCACCGGGAACTATAATGATGG
GATATAATAGTCTCCCAACCCCACTCTAGC|TTAACATTGGCAATCAGATGGGATGCACTA
GTCTCATAGGCAACGACCTTCCAGGAGCGA|GCCAGATCGCGAGTCGTTTGACTCCTTTCG
TATAACAGCCCAATAGGGTGCTCTTTGCCT|GTCTCCCAACCCCACTCTAGCCCTCTCGCG
GGCGCTGCGAAATTTGTTATATATAATAGT|GTGGCAAATTAGAGTCGCCGAAGAGCCACG
CTTTCTTGGTCCGGATCATAGGTGCCGGTA|ATATAATAGTCTCCCAACCCCACTCTATAA
ATCGCGAGTCGTTTGACTCCTTTCGGGACA|ACTCTAGCCCCCAACCCCACTCTAGCCCAT
CTACAGTAAACTCTCGGCCCTGCTACTAGA|CCCAACCCCACTCTAGCCCCGCCATCTGGT
ATGGATTCATCGACGATCTTTTCAACTTTC|GGGACGGCGCTGCGAAATTTGTTATATATA
TATAATAGTCTCCCAACCCCACTCTAGCCC|AACAGCCCAATAGGGTGCTCTTTGCCTACG
GCCCCCAACCCCACTCTAGCCCATGTTGAC|CAGTGGTCATCAGCGTCCAACTTCCCGGTA
TGCTCTTTGCCTACGAATGGACTGGGACGG|AGCCCTCTCGCGCCGTTTCAGGTGTGAGGT
CCACTCTAGCCCCGCTACGGCGAGCTTCTT|CCCAACCCCACTCTAGCCCAAGCCCGTCCT
AATAGTCTCCCAACCCCACTCTAGCCCTAG|AATAGTCTCCCAACCCCACTCTAGCCCCGC
TATAATAGTCTCCCAACCCCACTCTAGCCC|TGACTGGGATGGAAAGCGGGTGTTTCAGGT
GATCGCGAGTCGTTTGACTCCTTTCGGGAC|CACTCTAGCCCCCAACCCCACTCTAGCCCA
AATAGTCTCCCAACCCCACTCTAGCCCGAA|AGCCCAATAGGGTGCTCTTTGCCTACGAAT
GTTTACAGGGTCAGAGGGATAAAGGCTCCT|GCTTAAGCTCTAATACGTAGCAGTGGTCAG
GTATGGATTCATCGACGATCTTTTCAACTT|CTGGGACGGCGCTGCGAAATTTGTTATATA
TTTCAGGTGTGAGGTGGCAAATTAGAGTCG|AGCCCACTTGAGAGGCCACCAAATATAATA
AATAGTCTCCCAACCCCACTCTAGCCCACT|GGACTGTTAGAAGATATTCGCCGTTTACAG
CCCAACCCCACTCTATAATAGTCTCCCAAC|TACAGAATACCAATATAATAGTCTCCCAAC
ATCAGTTGCTCACACGAAGATATAATAGTC|ATTATACATTCTACAGTAAACTCTCGGCCC
CTCCCAACCCCACTCTAGCCCACTTGAGAG|TTAGAAGATATTCGCCGTTTACAGGGTCAG
TCGGTTGTGTATTTATATAATAGTCTCCCA|ACCCCACTCTAGCCCTGACTGGGATGGAAA
TCTAGCCCTAGCCCATAGTCTCCCAACCCC|TCTAGCCCCGCTACGGCGAGCTTCTTATAA
CTATAACAGCCCAATAGGGTGCTCTTTGCC|AGTCTCCCAACCCCACTCTAGCCCTCTCGC
GAAAGCGGGTGTTTCAGGTTATTGCCAGAT|ATAGTCTCTATAATAGTCTCCCAACCCCAC
TATTAAGGAGGTATAATAGTCTCTATAATA|GAAGAGGCCTAGTGGGAACTCCTTCGTTAG
TGTAGCATAGTGTGTGGACTGGCAGGCTGA|ATTCCATGTTAAGGCCCACAGCAGTCCATC
TGCGAAATTTGTTATATATAATAGTCTCCC|AAATTAGAGTCGCCGAAGAGCCACGGCTAC
CCAACCCCACTCTAGCCCACTTGTCTCCTA|TTCGGTGATATGCATGCGTGGCAGTAAGGC
GCCGTTTACAGGGTCAGAGGGATAAAGGCT|ACTGCTTAAGCTCTAATACGTAGCAGTGGT
CCAACCCCACTCTAGCCCTCTCGCGCCGTT|TCTTATAATAGTCTCCCAACCCCACTCTAG
GCCCTAGCCCATAGTCTCCCAACCCCACTC|GCCCCGCTACGGCGAGCTTCTTATAATAGT
AATAGTCTCCCAACCCCACTCTAGCCCTTG|TAGTCTCCCAACCCCACTCTAGCCCGCGGG
CCCCACTCTAGCCCCGCCATCTGGTTAGCC|TGGGATGCACTAATGATACCTTCCTTCAGA
TAGAGTCGCCGAAGAGCCACGGCTACAGAA|ATATAATAGTCTCCCAACCCCACTCTAGCC
GGCTCCTTAAGGTTCGGTGATATGCATGCG|TGGTCAGTGCTAATGTTAGTGGTATAATAG
GCAACGACCTTCCAGGAGCGATAAATTCCT|CGAGTCGTTTGACTCCTTTCGGGACACGGG
AGCCCGCGGGTCTCATAGGCAACGACCTTC|CAGGTTATTGCCAGATCGCGAGTCGTTTGA
GGGATGGAAAGCGGGTGTTTCAGGTTATTG|GGTATAATAGTCTCTATAATAGTCTCCCAA
AGGTTCGGTGATATGCATGCGTGGCAGTAA|CTAATGTTAGTGGTATAATAGTCTCCCAAC
CCCACTCTAGCCCTTGAATTCCATGTTAAG|CACTCTAGCCCGCGGGTCTCATAGGCAACG
GACAAGGGAATGTAGCATAGTGTGTGGACT|TAGCCCTTGAATTCCATGTTAAGGCCCACA
GAAGATATTCGCCGTTTACAGGGTCAGAGG|TTCCCCGACCACTGCTTAAGCTCTAATACG
CCAACCCCACTCTAGCCCGAACCAGTATGG|GGGTGCTCTTTGCCTACGAATGGACTGGGA
TCAACTTTCTTGGTCCGGATCATAGGTGCC|TTATATATAATAGTCTCCCAACCCCACTCT
CAGAGGGATAAAGGCTCCTTAAGGTTCGGT|AATACGTAGCAGTGGTCAGTGCTAATGTTA
GTGGGAACTCCTTCGTTAGCTATTGCGCAG|CCATGCCTTCTGCCTGAATGGCTCGGACCG
AACCCCACTCTAGCCCTTGAATTCCATGTT|CCCCACTCTAGCCCGCGGGTCTCATAGGCA
GGCAACGACCTTCCAGGAGCGATAAATTCC|GCGAGTCGTTTGACTCCTTTCGGGACACGG
CAACCCCACTCTAGCCCGCGGGTCTCATAG|AAGCGGGTGTTTCAGGTTATTGCCAGATCG
GGCCCACAGCAGTCCATCTTGTGTACGGCT|GACCTTCCAGGAGCGATAAATTCCTCAGCT
CTCTAGCCCCGCCATCTGGTTAGCCGGAAG|TGCACTAATGATACCTTCCTTCAGATTTTT
AGTCTCCCAACCCCACTCTAGCCCGCGGGT|GGATGGAAAGCGGGTGTTTCAGGTTATTGC
TAGCCCACTTGTCTCCTATATAATAGTCTC|CATGCGTGGCAGTAAGGCTTGCGACAAGGG
ATAAATTCCTCAGCTCTATCAGTTGCTCAC|GGGACACGGGAGATAACATTATACATTCTA
GATAAAGGCTCCTTAAGGTTCGGTGATATG|TAGCAGTGGTCAGTGCTAATGTTAGTGGTA
CACTCTAGCCCGCGGGTCTCATAGGCAACG|GTGTTTCAGGTTATTGCCAGATCGCGAGTC
GAGCCACGGCTACAGAATACCAATATAATA|CCAACCCCACTCTAGCCCACTTGTCTCCTA
TTATTAAGGAGGTATAATAGTCTCTATAAT|GGAAGAGGCCTAGTGGGAACTCCTTCGTTA
TCAGTGCTAATGTTAGTGGTATAATAGTCT|TCTCGGTTGTGTATTTATATAATAGTCTCC
ATGTTGACATGATATAATAGTCTCCCAACC|TCCCGGTAGATTAACATTGGCAATCAGATG
CTCTAGCCCACTTGAGAGGCCACCAAATAT|CGCCGTTTACAGGGTCAGAGGGATAAAGGC
TGTTAGAAGATATTCGCCGTTTACAGGGTC|GGGCCTTCCCCGACCACTGCTTAAGCTCTA
CGGTGATATGCATGCGTGGCAGTAAGGCTT|GTTAGTGGTATAATAGTCTCCCAACCCCAC
GCCCGAACCAGTATGGATTCATCGACGATC|TACGAATGGACTGGGACGGCGCTGCGAAAT
CGATCTTTTCAACTTTCTTGGTCCGGATCA|GAAATTTGTTATATATAATAGTCTCCCAAC
GAATGTAGCATAGTGTGTGGACTGGCAGGC|TGAATTCCATGTTAAGGCCCACAGCAGTCC
TCGCGAGTCGTTTGACTCCTTTCGGGACAC|CTCTAGCCCCCAACCCCACTCTAGCCCATG
CCGTTTCAGGTGTGAGGTGGCAAATTAGAG|TCTAGCCCACTTGAGAGGCCACCAAATATA
ACAGGGTCAGAGGGATAAAGGCTCCTTAAG|AAGCTCTAATACGTAGCAGTGGTCAGTGCT
GTTAAGGCCCACAGCAGTCCATCTTGTGTA|GCAACGACCTTCCAGGAGCGATAAATTCCT
AGCCCCGCTACGGCGAGCTTCTTATAATAG|CCACTCTAGCCCAAGCCCGTCCTACGGACT
TCTACAGTAAACTCTCGGCCCTGCTACTAG|TCCCAACCCCACTCTAGCCCCGCCATCTGG
CGTTTACAGGGTCAGAGGGATAAAGGCTCC|TGCTTAAGCTCTAATACGTAGCAGTGGTCA
TCCTCAGCTCTATCAGTTGCTCACACGAAG|CGGGAGATAACATTATACATTCTACAGTAA
GGGAGATAACATTATACATTCTACAGTAAA|TTGACATGATATAATAGTCTCCCAACCCCA
GTCAGTGCTAATGTTAGTGGTATAATAGTC|GTCTCGGTTGTGTATTTATATAATAGTCTC
ATAATAGTCTCCCAACCCCACTCTAGCCCA|ACGGACTGTTAGAAGATATTCGCCGTTTAC
TGGTCAGTGCTAATGTTAGTGGTATAATAG|AGGTCTCGGTTGTGTATTTATATAATAGTC
CGGTTGTGTATTTATATAATAGTCTCCCAA|CCCCACTCTAGCCCTGACTGGGATGGAAAG
AGTGGTATAATAGTCTCCCAACCCCACTCT|TTATATAATAGTCTCCCAACCCCACTCTAG
TTCTTATAATAGTCTCCCAACCCCACTCTA|GTCCTACGGACTGTTAGAAGATATTCGCCG
GCTCTTTGCCTACGAATGGACTGGGACGGC|GCCCTCTCGCGCCGTTTCAGGTGTGAGGTG
AGTCTCCCAACCCCACTCTAGCCCCGCCAT|GGCAATCAGATGGGATGCACTAATGATACC
CGGGTGTTTCAGGTTATTGCCAGATCGCGA|CTCTATAATAGTCTCCCAACCCCACTCTAG
TATTGCCAGATCGCGAGTCGTTTGACTCCT|CCCAACCCCACTCTAGCCCCCAACCCCACT
ACAGCAGTCCATCTTGTGTACGGCTGCTAG|TCCAGGAGCGATAAATTCCTCAGCTCTATC
ACTCTAGCCCGCGGGTCTCATAGGCAACGA|TGTTTCAGGTTATTGCCAGATCGCGAGTCG
AATGTTAGTGGTATAATAGTCTCCCAACCC|GTGTATTTATATAATAGTCTCCCAACCCCA
GGCCCTGCTACTAGATTTAATTATTAAGGA|GCCCCGCCATCTGGTTAGCCGGAAGAGGCC
TCTAGCCCATGTTGACATGATATAATAGTC|GTCCAACTTCCCGGTAGATTAACATTGGCA
TCAGAGGGATAAAGGCTCCTTAAGGTTCGG|TAATACGTAGCAGTGGTCAGTGCTAATGTT
AAGGTTCGGTGATATGCATGCGTGGCAGTA|GCTAATGTTAGTGGTATAATAGTCTCCCAA
CCGGATCATAGGTGCCGGTATAATAGTCTC|CTCCCAACCCCACTCTATAATAGTCTCCCA
TCCCAACCCCACTCTAGCCCTCTCGCGCCG|CTTCTTATAATAGTCTCCCAACCCCACTCT
CTATATAATAGTCTCCCAACCCCACTCTAG|GGCTTGCGACAAGGGAATGTAGCATAGTGT
CCCGCGGGTCTCATAGGCAACGACCTTCCA|GGTTATTGCCAGATCGCGAGTCGTTTGACT
TCCAGGAGCGATAAATTCCTCAGCTCTATC|GACTCCTTTCGGGACACGGGAGATAACATT
CTCCCAACCCCACTCTAGCCCTCTCGCGCC|GCTTCTTATAATAGTCTCCCAACCCCACTC
TAGTGGTATAATAGTCTCCCAACCCCACTC|TTTATATAATAGTCTCCCAACCCCACTCTA
TTACAGGGTCAGAGGGATAAAGGCTCCTTA|TTAAGCTCTAATACGTAGCAGTGGTCAGTG
CCCTAGCCCATAGTCTCCCAACCCCACTCT|CCCCGCTACGGCGAGCTTCTTATAATAGTC
GCTACTAGATTTAATTATTAAGGAGGTATA|CCATCTGGTTAGCCGGAAGAGGCCTAGTGG
TGTGTATTTATATAATAGTCTCCCAACCCC|ACTCTAGCCCTGACTGGGATGGAAAGCGGG
AAGAGGCCTAGTGGGAACTCCTTCGTTAGC|TTTACATAGACCATGCCTTCTGCCTGAATG
CAGTAAACTCTCGGCCCTGCTACTAGATTT|AACCCCACTCTAGCCCCGCCATCTGGTTAG
CGGGAGATAACATTATACATTCTACAGTAA|GTTGACATGATATAATAGTCTCCCAACCCC
TAATTATTAAGGAGGTATAATAGTCTCTAT|GCCGGAAGAGGCCTAGTGGGAACTCCTTCG
GTTAGCCGGAAGAGGCCTAGTGGGAACTCC|CTTCAGATTTTTACATAGACCATGCCTTCT
AGGGATAAAGGCTCCTTAAGGTTCGGTGAT|ACGTAGCAGTGGTCAGTGCTAATGTTAGTG
CCGGTATAATAGTCTCCCAACCCCACTCTA|CTATAATAGTCTCCCAACCCCACTCTAGCC
CTCTCGCGCCGTTTCAGGTGTGAGGTGGCA|AACCCCACTCTAGCCCACTTGAGAGGCCAC
TCTAGCCCACTTGTCTCCTATATAATAGTC|TGCATGCGTGGCAGTAAGGCTTGCGACAAG
CCAGTGGTCATCAGCGTCCAACTTCCCGGT|CCACCGGGAACTATAATGATGGGCACTGTG
AGTCTCCCAACCCCACTCTAGCCCGAACCA|CCAATAGGGTGCTCTTTGCCTACGAATGGA
ATCGACGATCTTTTCAACTTTCTTGGTCCG|GCTGCGAAATTTGTTATATATAATAGTCTC
CCACTCTAGCCCAAGCCCGTCCTACGGACT|GCATAGTGTGTGGACTGGCAGGCTGACTTG
GATCTTTTCAACTTTCTTGGTCCGGATCAT|AAATTTGTTATATATAATAGTCTCCCAACC
CCACTCTAGCCCTCTCGCGCCGTTTCAGGT|AATAGTCTCCCAACCCCACTCTAGCCCACT
GCCTACGAATGGACTGGGACGGCGCTGCGA|CGCGCCGTTTCAGGTGTGAGGTGGCAAATT
TCAGGTGTGAGGTGGCAAATTAGAGTCGCC|CCCACTTGAGAGGCCACCAAATATAATAGT
TAGTCTCCCAACCCCACTCTAGCCCACTTG|ACTGTTAGAAGATATTCGCCGTTTACAGGG
GTCTCCCAACCCCACTCTAGCCCACTTGAG|TGTTAGAAGATATTCGCCGTTTACAGGGTC
TACGAATGGACTGGGACGGCGCTGCGAAAT|GCCGTTTCAGGTGTGAGGTGGCAAATTAGA
TCTAGCCCTTGAATTCCATGTTAAGGCCCA|TAGCCCGCGGGTCTCATAGGCAACGACCTT
GAAGATATAATAGTCTCCCAACCCCACTCT|GTAAACTCTCGGCCCTGCTACTAGATTTAA
AATTCCATGTTAAGGCCCACAGCAGTCCAT|TCTCATAGGCAACGACCTTCCAGGAGCGAT
GTACGGCTGCTAGGCGGAGGATGTCGCTTT|CCTCAGCTCTATCAGTTGCTCACACGAAGA
AGATCGCGAGTCGTTTGACTCCTTTCGGGA|CCACTCTAGCCCCCAACCCCACTCTAGCCC
GTCTCCCAACCCCACTCTAGCCCTAGCCCA|GTCTCCCAACCCCACTCTAGCCCCGCTACG
CTTGAATTCCATGTTAAGGCCCACAGCAGT|CGGGTCTCATAGGCAACGACCTTCCAGGAG
AGGTATAATAGTCTCTATAATAGTCTCCCA|CTAGTGGGAACTCCTTCGTTAGCTATTGCG
TAGTCTCCCAACCCCACTCTAGCCCGTCAT|TCTCCCAACCCCACTCTAGCCCTAGCCCAT
ACCAATATAATAGTCTCCCAACCCCACTCT|ACTTGTCTCCTATATAATAGTCTCCCAACC
AATAGTCTCCCAACCCCACTCTAGCCCAAG|CGACAAGGGAATGTAGCATAGTGTGTGGAC
AAGGAGGTATAATAGTCTCTATAATAGTCT|AGGCCTAGTGGGAACTCCTTCGTTAGCTAT
TGTGAGGTGGCAAATTAGAGTCGCCGAAGA|TTGAGAGGCCACCAAATATAATAGTCTCCC
GTGGTATAATAGTCTCCCAACCCCACTCTA|TATATAATAGTCTCCCAACCCCACTCTAGC
ACCCCACTCTAGCCCTCTCGCGCCGTTTCA|TATAATAGTCTCCCAACCCCACTCTAGCCC
TTGTGTATTTATATAATAGTCTCCCAACCC|CACTCTAGCCCTGACTGGGATGGAAAGCGG
TAGCCCGAACCAGTATGGATTCATCGACGA|CCTACGAATGGACTGGGACGGCGCTGCGAA
CCCAACCCCACTCTAGCCCACTTGAGAGGC|AGAAGATATTCGCCGTTTACAGGGTCAGAG
CGCTTTTATTTCTCTTAGGTCTCGGTTGTG|CGAAGATATAATAGTCTCCCAACCCCACTC
TGACTTGGGCCTTCCCCGACCACTGCTTAA|ATCTTGTGTACGGCTGCTAGGCGGAGGATG
ATACCAATATAATAGTCTCCCAACCCCACT|CCACTTGTCTCCTATATAATAGTCTCCCAA
GAATACCAATATAATAGTCTCCCAACCCCA|GCCCACTTGTCTCCTATATAATAGTCTCCC
GTTTCAGGTGTGAGGTGGCAAATTAGAGTC|TAGCCCACTTGAGAGGCCACCAAATATAAT
AATAGTCTCCCAACCCCACTCTAGCCCTGA|TCGGCCCTGCTACTAGATTTAATTATTAAG
TAGCATAGTGTGTGGACTGGCAGGCTGACT|TCCATGTTAAGGCCCACAGCAGTCCATCTT
TCTCTTAGGTCTCGGTTGTGTATTTATATA|ATAGTCTCCCAACCCCACTCTAGCCCTGAC
ATAGTCTCCCAACCCCACTCTAGCCCACTT|GACTGTTAGAAGATATTCGCCGTTTACAGG
CTACGGCGAGCTTCTTATAATAGTCTCCCA|AGCCCAAGCCCGTCCTACGGACTGTTAGAA
AGGCTTGCGACAAGGGAATGTAGCATAGTG|CCCCACTCTAGCCCTTGAATTCCATGTTAA
GCATGCGTGGCAGTAAGGCTTGCGACAAGG|ATAATAGTCTCCCAACCCCACTCTAGCCCT
GCCATCTGGTTAGCCGGAAGAGGCCTAGTG|ATACCTTCCTTCAGATTTTTACATAGACCA
TAATAGTCTCTATAATAGTCTCCCAACCCC|GGGAACTCCTTCGTTAGCTATTGCGCAGAA
TTTCTCTTAGGTCTCGGTTGTGTATTTATA|TAATAGTCTCCCAACCCCACTCTAGCCCTG
TCTAGCCCAAGCCCGTCCTACGGACTGTTA|AGTGTGTGGACTGGCAGGCTGACTTGGGCC
TGTATTTATATAATAGTCTCCCAACCCCAC|TCTAGCCCTGACTGGGATGGAAAGCGGGTG
CTCATAGGCAACGACCTTCCAGGAGCGATA|CAGATCGCGAGTCGTTTGACTCCTTTCGGG
GTATAATAGTCTCCCAACCCCACTCTAGCC|ATAATAGTCTCCCAACCCCACTCTAGCCCG
GGATAAAGGCTCCTTAAGGTTCGGTGATAT|GTAGCAGTGGTCAGTGCTAATGTTAGTGGT
TAGCCCATAGTCTCCCAACCCCACTCTAGC|CGCTACGGCGAGCTTCTTATAATAGTCTCC
GGGAATGTAGCATAGTGTGTGGACTGGCAG|CTTGAATTCCATGTTAAGGCCCACAGCAGT
AATAGTCTCCCAACCCCACTCTAGCCCCGC|ATTGGCAATCAGATGGGATGCACTAATGAT
GCGAAATTTGTTATATATAATAGTCTCCCA|AATTAGAGTCGCCGAAGAGCCACGGCTACA
CATCTGGTTAGCCGGAAGAGGCCTAGTGGG|ACCTTCCTTCAGATTTTTACATAGACCATG
GGGTGTTTCAGGTTATTGCCAGATCGCGAG|TCTATAATAGTCTCCCAACCCCACTCTAGC
TGCCTACGAATGGACTGGGACGGCGCTGCG|TCGCGCCGTTTCAGGTGTGAGGTGGCAAAT
CGCGAGTCGTTTGACTCCTTTCGGGACACG|TCTAGCCCCCAACCCCACTCTAGCCCATGT
ATAGTCTCCCAACCCCACTCTAGCCCTGAC|CGGCCCTGCTACTAGATTTAATTATTAAGG
TCCATCTTGTGTACGGCTGCTAGGCGGAGG|GCGATAAATTCCTCAGCTCTATCAGTTGCT
TCTTTTCAACTTTCTTGGTCCGGATCATAG|ATTTGTTATATATAATAGTCTCCCAACCCC
GTTGCTCACACGAAGATATAATAGTCTCCC|TACATTCTACAGTAAACTCTCGGCCCTGCT
CCAACCCCACTCTAGCCCCCAACCCCACTC|GCGCAGAATTTGACCAGTGGTCATCAGCGT
TCTAGCCCCGCTACGGCGAGCTTCTTATAA|ACCCCACTCTAGCCCAAGCCCGTCCTACGG
ATATAATAGTCTCCCAACCCCACTCTAGCC|TAACATTGGCAATCAGATGGGATGCACTAA
CGTAGCAGTGGTCAGTGCTAATGTTAGTGG|TTTCTCTTAGGTCTCGGTTGTGTATTTATA
GTGCTCTTTGCCTACGAATGGACTGGGACG|TAGCCCTCTCGCGCCGTTTCAGGTGTGAGG
CCACCAAATATAATAGTCTCCCAACCCCAC|GGGATAAAGGCTCCTTAAGGTTCGGTGATA
ACGGCGCTGCGAAATTTGTTATATATAATA|AGGTGGCAAATTAGAGTCGCCGAAGAGCCA
CTCCTTCGTTAGCTATTGCGCAGAATTTGA|TTCTGCCTGAATGGCTCGGACCGCAGGCGG
ACCCCACTCTAGCCCCGCCATCTGGTTAGC|ATGGGATGCACTAATGATACCTTCCTTCAG
ACCCCACTCTAGCCCCCAACCCCACTCTAG|CAGAATTTGACCAGTGGTCATCAGCGTCCA
CACTCTAGCCCACTTGTCTCCTATATAATA|ATATGCATGCGTGGCAGTAAGGCTTGCGAC
CCCCACTCTAGCCCCCAACCCCACTCTAGC|AGAATTTGACCAGTGGTCATCAGCGTCCAA
TATAATAGTCTCCCAACCCCACTCTAGCCC|TACGGACTGTTAGAAGATATTCGCCGTTTA
CGAGCTTCTTATAATAGTCTCCCAACCCCA|AGCCCGTCCTACGGACTGTTAGAAGATATT
GCCCTTGAATTCCATGTTAAGGCCCACAGC|CCGCGGGTCTCATAGGCAACGACCTTCCAG
ACCAGTATGGATTCATCGACGATCTTTTCA|TGGACTGGGACGGCGCTGCGAAATTTGTTA
ATATATAATAGTCTCCCAACCCCACTCTAT|CGAAGAGCCACGGCTACAGAATACCAATAT
GCCTAGTGGGAACTCCTTCGTTAGCTATTG|ATAGACCATGCCTTCTGCCTGAATGGCTCG
ACTTGGGCCTTCCCCGACCACTGCTTAAGC|CTTGTGTACGGCTGCTAGGCGGAGGATGTC
CCCAACCCCACTCTAGCCCCGCCATCTGGT|TCAGATGGGATGCACTAATGATACCTTCCT
CGTGGCAGTAAGGCTTGCGACAAGGGAATG|AGTCTCCCAACCCCACTCTAGCCCTTGAAT
AGTCCATCTTGTGTACGGCTGCTAGGCGGA|GAGCGATAAATTCCTCAGCTCTATCAGTTG
CATTCTACAGTAAACTCTCGGCCCTGCTAC|GTCTCCCAACCCCACTCTAGCCCCGCCATC
AATAGTCTCCCAACCCCACTCTAGCCCACT|TCCTTAAGGTTCGGTGATATGCATGCGTGG
AATATAATAGTCTCCCAACCCCACTCTAGC|AAGGCTCCTTAAGGTTCGGTGATATGCATG
CCACAGCAGTCCATCTTGTGTACGGCTGCT|CTTCCAGGAGCGATAAATTCCTCAGCTCTA
TCAGGTTATTGCCAGATCGCGAGTCGTTTG|TAGTCTCCCAACCCCACTCTAGCCCCCAAC
GCCCTGACTGGGATGGAAAGCGGGTGTTTC|TATTAAGGAGGTATAATAGTCTCTATAATA
GGACACGGGAGATAACATTATACATTCTAC|CCCATGTTGACATGATATAATAGTCTCCCA
CCCCACTCTAGCCCTAGCCCATAGTCTCCC|CCCCACTCTAGCCCCGCTACGGCGAGCTTC
TTCAACTTTCTTGGTCCGGATCATAGGTGC|GTTATATATAATAGTCTCCCAACCCCACTC
GGTCTCATAGGCAACGACCTTCCAGGAGCG|TGCCAGATCGCGAGTCGTTTGACTCCTTTC
ATAGTCTCCCAACCCCACTCTAGCCCGCGG|TGGGATGGAAAGCGGGTGTTTCAGGTTATT
CGCCATCTGGTTAGCCGGAAGAGGCCTAGT|GATACCTTCCTTCAGATTTTTACATAGACC
CTAGGCGGAGGATGTCGCTTTTATTTCTCT|TATCAGTTGCTCACACGAAGATATAATAGT
GGCTACAGAATACCAATATAATAGTCTCCC|CACTCTAGCCCACTTGTCTCCTATATAATA
TTGCCTACGAATGGACTGGGACGGCGCTGC|CTCGCGCCGTTTCAGGTGTGAGGTGGCAAA
GTCTCCCAACCCCACTCTAGCCCCGCTACG|TATAATAGTCTCCCAACCCCACTCTAGCCC
TCGCCGAAGAGCCACGGCTACAGAATACCA|ATAGTCTCCCAACCCCACTCTAGCCCACTT
AGTCTCCCAACCCCACTCTAGCCCTAGCCC|AGTCTCCCAACCCCACTCTAGCCCCGCTAC
AAGGCTTGCGACAAGGGAATGTAGCATAGT|ACCCCACTCTAGCCCTTGAATTCCATGTTA
GGCTTGCGACAAGGGAATGTAGCATAGTGT|CCCACTCTAGCCCTTGAATTCCATGTTAAG
CTAGCCCCGCCATCTGGTTAGCCGGAAGAG|CACTAATGATACCTTCCTTCAGATTTTTAC
CCCGCCATCTGGTTAGCCGGAAGAGGCCTA|ATGATACCTTCCTTCAGATTTTTACATAGA
GGAGATAACATTATACATTCTACAGTAAAC|TGACATGATATAATAGTCTCCCAACCCCAC
TCTCCCAACCCCACTCTAGCCCGAACCAGT|AATAGGGTGCTCTTTGCCTACGAATGGACT
TATAATAGTCTCCCAACCCCACTCTATAAT|AGAGCCACGGCTACAGAATACCAATATAAT
TCCCAACCCCACTCTAGCCCTAGCCCATAG|TCCCAACCCCACTCTAGCCCCGCTACGGCG
ACGGCTACAGAATACCAATATAATAGTCTC|CCCACTCTAGCCCACTTGTCTCCTATATAA
GGAAGAGGCCTAGTGGGAACTCCTTCGTTA|TTTTTACATAGACCATGCCTTCTGCCTGAA
GCCCTCTCGCGCCGTTTCAGGTGTGAGGTG|CCCAACCCCACTCTAGCCCACTTGAGAGGC
